CODICE_ISTAT;denominazione_comune;sigla_provincia;popolazione_censita;M;F;undefined;Total
100001;CANTAGALLO;PO;3092;11;6;0;17
100002;CARMIGNANO;PO;14753;10;12;0;22
100003;MONTEMURLO;PO;19100;13;9;0;22
100004;POGGIO A CAIANO;PO;9956;12;5;0;17
100005;PRATO;PO;195213;25;17;0;42
100006;VAIANO;PO;9943;10;7;0;17
100007;VERNIO;PO;6066;10;7;0;17
101001;BELVEDERE DI SPINELLO;KR;1973;8;5;0;13
101002;CACCURI;KR;1553;11;2;0;13
101003;CARFIZZI;KR;524;10;3;0;13
101004;CASABONA;KR;2377;9;4;0;13
101005;CASTELSILANO;KR;900;9;4;0;13
101006;CERENZIA;KR;1035;10;3;0;13
101007;CIRO';KR;2534;11;6;0;17
101008;CIRO' MARINA;KR;14002;15;7;0;22
101009;COTRONEI;KR;5261;12;5;0;17
101010;CROTONE;KR;59359;26;16;0;42
101011;CRUCOLI;KR;2781;12;5;0;17
101012;CUTRO;KR;9478;12;10;0;22
101013;ISOLA DI CAPO RIZZUTO;KR;17281;15;6;0;21
101014;MELISSA;KR;3274;10;7;0;17
101015;MESORACA;KR;5908;8;9;0;17
101016;PALLAGORIO;KR;1019;10;3;0;13
101017;PETILIA POLICASTRO;KR;8714;10;7;0;17
101018;ROCCABERNARDA;KR;3167;12;5;0;17
101019;ROCCA DI NETO;KR;5343;10;7;0;17
101020;SAN MAURO MARCHESATO;KR;1952;12;1;0;13
101021;SAN NICOLA DELL'ALTO;KR;721;8;5;0;13
101022;SANTA SEVERINA;KR;1929;11;2;0;13
101024;SCANDALE;KR;2889;10;3;0;13
101025;STRONGOLI;KR;6163;0;0;1;1
101026;UMBRIATICO;KR;755;10;3;0;13
101027;VERZINO;KR;1616;9;4;0;13
102001;ACQUARO;VV;1891;10;3;0;13
102002;ARENA;VV;1253;8;4;0;12
102003;BRIATICO;VV;3781;9;5;0;14
102004;BROGNATURO;VV;668;11;2;0;13
102005;CAPISTRANO;VV;980;10;3;0;13
102006;CESSANITI;VV;2999;0;0;1;1
102007;DASA';VV;1113;8;5;0;13
102008;DINAMI;VV;1828;12;1;0;13
102009;DRAPIA;VV;2062;9;4;0;13
102010;FABRIZIA;VV;2003;11;2;0;13
102011;FILADELFIA;VV;4948;9;8;0;17
102012;FILANDARI;VV;1771;10;3;0;13
102013;FILOGASO;VV;1337;8;5;0;13
102014;FRANCAVILLA ANGITOLA;VV;1807;9;4;0;13
102015;FRANCICA;VV;1578;12;1;0;13
102016;GEROCARNE;VV;1936;13;0;0;13
102017;IONADI;VV;4502;11;6;0;17
102018;JOPPOLO;VV;1671;12;1;0;13
102019;LIMBADI;VV;3267;10;7;0;17
102020;MAIERATO;VV;2056;9;2;0;11
102021;MILETO;VV;6415;11;6;0;17
102022;MONGIANA;VV;650;10;2;0;12
102023;MONTEROSSO CALABRO;VV;1548;8;5;0;13
102024;NARDODIPACE;VV;1115;12;1;0;13
102025;NICOTERA;VV;5835;12;5;0;17
102026;PARGHELIA;VV;1261;11;2;0;13
102027;PIZZO;VV;8878;10;6;0;16
102028;PIZZONI;VV;1000;8;5;0;13
102029;POLIA;VV;840;8;4;0;12
102030;RICADI;VV;4959;11;6;0;17
102031;ROMBIOLO;VV;4354;12;5;0;17
102032;SAN CALOGERO;VV;3942;14;3;0;17
102033;SAN COSTANTINO CALABRO;VV;2089;10;2;0;12
102034;SAN GREGORIO D'IPPONA;VV;2521;6;7;0;13
102035;SAN NICOLA DA CRISSA;VV;1244;9;4;0;13
102036;SANT'ONOFRIO;VV;2872;10;3;0;13
102037;SERRA SAN BRUNO;VV;6355;12;5;0;17
102038;SIMBARIO;VV;923;8;5;0;13
102039;SORIANELLO;VV;1098;8;5;0;13
102040;SORIANO CALABRO;VV;2306;0;0;3;3
102041;SPADOLA;VV;799;13;0;0;13
102042;SPILINGA;VV;1345;11;2;0;13
102043;STEFANACONI;VV;2345;11;2;0;13
102044;TROPEA;VV;5911;9;8;0;17
102045;VALLELONGA;VV;719;10;3;0;13
102046;VAZZANO;VV;964;12;1;0;13
102047;VIBO VALENTIA;VV;31480;26;16;0;42
102048;ZACCANOPOLI;VV;673;6;7;0;13
102049;ZAMBRONE;VV;1784;7;6;0;13
102050;ZUNGRI;VV;1882;10;3;0;13
103001;ANTRONA SCHIERANCO;VB;400;11;2;0;13
103002;ANZOLA D'OSSOLA;VB;381;6;7;0;13
103003;ARIZZANO;VB;1941;9;4;0;13
103004;AROLA;VB;241;7;6;0;13
103005;AURANO;VB;103;6;7;0;13
103006;BACENO;VB;869;10;3;0;13
103007;BANNIO ANZINO;VB;476;6;4;0;10
103008;BAVENO;VB;4742;12;5;0;17
103009;BEE;VB;758;12;1;0;13
103010;BELGIRATE;VB;498;6;7;0;13
103011;BEURA-CARDEZZA;VB;1437;7;6;0;13
103012;BOGNANCO;VB;191;10;3;0;13
103013;BROVELLO-CARPUGNINO;VB;774;7;6;0;13
103014;CALASCA-CASTIGLIONE;VB;567;7;6;0;13
103015;CAMBIASCA;VB;1568;9;4;0;13
103016;CANNERO RIVIERA;VB;910;9;4;0;13
103017;CANNOBIO;VB;5000;11;6;0;17
103018;CAPREZZO;VB;171;8;2;0;10
103019;CASALE CORTE CERRO;VB;3385;9;8;0;17
103021;CEPPO MORELLI;VB;301;9;3;0;12
103022;CESARA;VB;597;8;5;0;13
103023;COSSOGNO;VB;668;8;5;0;13
103024;CRAVEGGIA;VB;758;7;5;0;12
103025;CREVOLADOSSOLA;VB;4510;14;3;0;17
103026;CRODO;VB;1419;11;2;0;13
103028;DOMODOSSOLA;VB;17684;13;8;0;21
103029;DRUOGNO;VB;1050;10;3;0;13
103031;FORMAZZA;VB;442;9;4;0;13
103032;GERMAGNO;VB;181;11;2;0;13
103033;GHIFFA;VB;2294;10;3;0;13
103034;GIGNESE;VB;1055;0;0;1;1
103035;GRAVELLONA TOCE;VB;7671;11;6;0;17
103036;GURRO;VB;190;9;4;0;13
103037;INTRAGNA;VB;100;12;1;0;13
103038;LOREGLIA;VB;217;11;0;0;11
103039;MACUGNAGA;VB;526;12;1;0;13
103040;MADONNA DEL SASSO;VB;371;6;7;0;13
103041;MALESCO;VB;1360;11;2;0;13
103042;MASERA;VB;1476;10;3;0;13
103043;MASSIOLA;VB;117;9;4;0;13
103044;MERGOZZO;VB;2156;11;2;0;13
103045;MIAZZINA;VB;368;11;2;0;13
103046;MONTECRESTESE;VB;1273;8;5;0;13
103047;MONTESCHENO;VB;380;8;5;0;13
103048;NONIO;VB;844;8;5;0;13
103049;OGGEBBIO;VB;854;9;4;0;13
103050;OMEGNA;VB;14503;12;10;0;22
103051;ORNAVASSO;VB;3354;12;5;0;17
103052;PALLANZENO;VB;1102;12;1;0;13
103053;PIEDIMULERA;VB;1465;10;3;0;13
103054;PIEVE VERGONTE;VB;2453;10;3;0;13
103055;PREMENO;VB;764;8;5;0;13
103056;PREMIA;VB;544;11;2;0;13
103057;PREMOSELLO-CHIOVENDA;VB;1838;8;4;0;12
103058;QUARNA SOPRA;VB;252;11;2;0;13
103059;QUARNA SOTTO;VB;365;8;4;0;12
103060;RE;VB;698;11;2;0;13
103061;SAN BERNARDINO VERBANO;VB;1256;6;5;0;11
103062;SANTA MARIA MAGGIORE;VB;1290;7;6;0;13
103064;STRESA;VB;4627;11;6;0;17
103065;TOCENO;VB;727;12;1;0;13
103066;TRAREGO VIGGIONA;VB;409;8;5;0;13
103067;TRASQUERA;VB;182;10;3;0;13
103068;TRONTANO;VB;1632;11;2;0;13
103069;VALSTRONA;VB;1163;9;3;0;12
103070;VANZONE CON SAN CARLO;VB;390;10;3;0;13
103071;VARZO;VB;1940;9;2;0;11
103072;VERBANIA;VB;29856;25;15;0;40
103074;VIGNONE;VB;1195;9;4;0;13
103075;VILLADOSSOLA;VB;6233;11;6;0;17
103076;VILLETTE;VB;273;9;4;0;13
103077;VOGOGNA;VB;1707;0;0;1;1
103078;BORGOMEZZAVALLE;VB;292;9;4;0;13
103079;VALLE CANNOBINA;VB;465;12;1;0;13
108001;AGRATE BRIANZA;MB;15505;13;9;0;22
108002;AICURZIO;MB;2071;8;5;0;13
108003;ALBIATE;MB;6574;10;7;0;17
108004;ARCORE;MB;17828;14;8;0;22
108005;BARLASSINA;MB;6873;9;8;0;17
108006;BELLUSCO;MB;7370;10;7;0;17
108007;BERNAREGGIO;MB;11385;13;9;0;22
108008;BESANA IN BRIANZA;MB;15442;17;5;0;22
108009;BIASSONO;MB;12217;11;11;0;22
108010;BOVISIO-MASCIAGO;MB;16756;16;6;0;22
108011;BRIOSCO;MB;6091;9;8;0;17
108012;BRUGHERIO;MB;34870;20;12;0;32
108013;BURAGO DI MOLGORA;MB;4206;9;8;0;17
108014;CAMPARADA;MB;2156;8;5;0;13
108015;CARATE BRIANZA;MB;17788;16;6;0;22
108016;CARNATE;MB;7594;9;8;0;17
108017;CAVENAGO DI BRIANZA;MB;7400;10;7;0;17
108018;CERIANO LAGHETTO;MB;6645;11;6;0;17
108019;CESANO MADERNO;MB;39042;21;11;0;32
108020;COGLIATE;MB;8459;10;6;0;16
108021;CONCOREZZO;MB;15763;14;8;0;22
108022;CORREZZANA;MB;3114;8;5;0;13
108023;DESIO;MB;41668;24;8;0;32
108024;GIUSSANO;MB;26015;13;9;0;22
108025;LAZZATE;MB;7699;11;6;0;17
108026;LESMO;MB;8419;9;8;0;17
108027;LIMBIATE;MB;34809;24;8;0;32
108028;LISSONE;MB;46191;24;8;0;32
108029;MACHERIO;MB;7449;9;8;0;17
108030;MEDA;MB;23350;12;10;0;22
108031;MEZZAGO;MB;4470;12;5;0;17
108032;MISINTO;MB;5664;10;7;0;17
108033;MONZA;MB;121984;29;13;0;42
108034;MUGGIO';MB;23513;14;8;0;22
108035;NOVA MILANESE;MB;23070;13;9;0;22
108036;ORNAGO;MB;5255;8;5;0;13
108037;RENATE;MB;3991;13;4;0;17
108038;RONCO BRIANTINO;MB;3581;14;3;0;17
108039;SEREGNO;MB;44825;22;10;0;32
108040;SEVESO;MB;23804;15;6;0;21
108041;SOVICO;MB;8314;11;6;0;17
108042;SULBIATE;MB;4417;9;8;0;17
108043;TRIUGGIO;MB;8668;10;7;0;17
108044;USMATE VELATE;MB;10483;12;10;0;22
108045;VAREDO;MB;13619;14;8;0;22
108046;VEDANO AL LAMBRO;MB;7504;10;7;0;17
108047;VEDUGGIO CON COLZANO;MB;4216;10;7;0;17
108048;VERANO BRIANZA;MB;9171;10;7;0;17
108049;VILLASANTA;MB;14068;14;8;0;22
108050;VIMERCATE;MB;25783;13;9;0;22
108051;BUSNAGO;MB;6764;10;6;0;16
108052;CAPONAGO;MB;5123;10;7;0;17
108053;CORNATE D'ADDA;MB;10784;12;10;0;22
108054;LENTATE SUL SEVESO;MB;15802;14;8;0;22
108055;RONCELLO;MB;4785;11;6;0;17
109001;ALTIDONA;FM;3507;9;8;0;17
109002;AMANDOLA;FM;3303;12;3;0;15
109003;BELMONTE PICENO;FM;586;7;6;0;13
109004;CAMPOFILONE;FM;1910;7;6;0;13
109005;FALERONE;FM;3142;12;5;0;17
109006;FERMO;FM;35923;31;10;0;41
109007;FRANCAVILLA D'ETE;FM;936;9;3;0;12
109008;GROTTAZZOLINA;FM;3214;10;7;0;17
109009;LAPEDONA;FM;1159;10;4;0;14
109010;MAGLIANO DI TENNA;FM;1432;9;4;0;13
109011;MASSA FERMANA;FM;878;10;3;0;13
109012;MONSAMPIETRO MORICO;FM;621;8;5;0;13
109013;MONTAPPONE;FM;1584;9;4;0;13
109014;MONTEFALCONE APPENNINO;FM;375;7;6;0;13
109015;MONTEFORTINO;FM;1077;11;2;0;13
109016;MONTE GIBERTO;FM;738;9;4;0;13
109017;MONTEGIORGIO;FM;6407;10;7;0;17
109018;MONTEGRANARO;FM;12497;12;10;0;22
109019;MONTELEONE DI FERMO;FM;357;8;5;0;13
109020;MONTELPARO;FM;713;9;4;0;13
109021;MONTE RINALDO;FM;324;9;4;0;13
109022;MONTERUBBIANO;FM;2041;8;5;0;13
109023;MONTE SAN PIETRANGELI;FM;2293;8;5;0;13
109024;MONTE URANO;FM;7887;9;8;0;17
109025;MONTE VIDON COMBATTE;FM;400;8;5;0;13
109026;MONTE VIDON CORRADO;FM;683;6;7;0;13
109027;MONTOTTONE;FM;878;11;2;0;13
109028;MORESCO;FM;524;9;4;0;13
109029;ORTEZZANO;FM;745;8;5;0;13
109030;PEDASO;FM;2811;8;5;0;13
109031;PETRITOLI;FM;2156;10;3;0;13
109032;PONZANO DI FERMO;FM;1641;9;4;0;13
109033;PORTO SAN GIORGIO;FM;15699;15;7;0;22
109034;PORTO SANT'ELPIDIO;FM;25757;16;6;0;22
109035;RAPAGNANO;FM;1927;7;6;0;13
109036;SANTA VITTORIA IN MATENANO;FM;1227;10;2;0;12
109037;SANT'ELPIDIO A MARE;FM;16543;15;7;0;22
109038;SERVIGLIANO;FM;2179;10;3;0;13
109039;SMERILLO;FM;336;12;1;0;13
109040;TORRE SAN PATRIZIO;FM;1884;8;5;0;13
110001;ANDRIA;BT;97588;29;12;0;41
110002;BARLETTA;BT;92798;28;13;0;41
110003;BISCEGLIE;BT;53738;22;8;0;30
110004;CANOSA DI PUGLIA;BT;28187;20;12;0;32
110006;MINERVINO MURGE;BT;8298;7;10;0;17
110007;SAN FERDINANDO DI PUGLIA;BT;13713;11;11;0;22
110008;SPINAZZOLA;BT;6027;10;7;0;17
110009;TRANI;BT;55035;30;11;0;41
110010;TRINITAPOLI;BT;13970;0;0;3;3
111001;ARBUS;SU;5843;12;10;0;22
111002;ARMUNGIA;SU;428;7;6;0;13
111003;BALLAO;SU;731;8;6;0;14
111004;BARRALI;SU;1095;11;6;0;17
111005;BARUMINI;SU;1176;14;3;0;17
111006;BUGGERRU;SU;1053;9;8;0;17
111007;BURCEI;SU;2666;11;6;0;17
111008;CALASETTA;SU;2802;13;3;0;16
111009;CARBONIA;SU;26565;20;11;0;31
111010;CARLOFORTE;SU;5983;14;8;0;22
111011;CASTIADAS;SU;1661;11;6;0;17
111012;COLLINAS;SU;781;8;5;0;13
111013;DECIMOPUTZU;SU;4205;12;5;0;17
111014;DOLIANOVA;SU;9496;13;9;0;22
111015;DOMUS DE MARIA;SU;1628;10;7;0;17
111016;DOMUSNOVAS;SU;5922;11;11;0;22
111017;DONORI;SU;1976;13;4;0;17
111018;ESCALAPLANO;SU;2092;14;3;0;17
111019;ESCOLCA;SU;543;7;7;0;14
111020;ESTERZILI;SU;565;7;6;0;13
111021;FLUMINIMAGGIORE;SU;2681;11;6;0;17
111022;FURTEI;SU;1525;15;2;0;17
111023;GENONI;SU;771;6;7;0;13
111024;GENURI;SU;314;7;7;0;14
111025;GERGEI;SU;1137;11;4;0;15
111026;GESICO;SU;771;9;5;0;14
111027;GESTURI;SU;1164;14;3;0;17
111028;GIBA;SU;1919;14;3;0;17
111029;GONI;SU;455;11;3;0;14
111030;GONNESA;SU;4697;13;4;0;17
111031;GONNOSFANADIGA;SU;6243;11;11;0;22
111032;GUAMAGGIORE;SU;919;8;5;0;13
111033;GUASILA;SU;2509;6;11;0;17
111034;GUSPINI;SU;11134;12;10;0;22
111035;IGLESIAS;SU;25382;21;11;0;32
111036;ISILI;SU;2503;9;7;0;16
111037;LAS PLASSAS;SU;215;10;4;0;14
111038;LUNAMATRONA;SU;1649;12;5;0;17
111039;MANDAS;SU;2028;14;3;0;17
111040;MASAINAS;SU;1227;12;5;0;17
111041;MONASTIR;SU;4469;11;6;0;17
111042;MURAVERA;SU;5171;12;10;0;22
111043;MUSEI;SU;1512;15;2;0;17
111044;NARCAO;SU;3105;11;6;0;17
111045;NURAGUS;SU;842;10;4;0;14
111046;NURALLAO;SU;1178;13;4;0;17
111047;NURAMINIS;SU;2339;9;8;0;17
111048;NURRI;SU;2034;12;5;0;17
111049;NUXIS;SU;1455;14;3;0;17
111050;ORROLI;SU;2017;13;4;0;17
111051;ORTACESUS;SU;883;7;7;0;14
111052;PABILLONIS;SU;2540;10;7;0;17
111053;PAULI ARBAREI;SU;564;8;4;0;12
111054;PERDAXIUS;SU;1326;15;2;0;17
111055;PIMENTEL;SU;1131;8;6;0;14
111056;PISCINAS;SU;816;9;5;0;14
111057;PORTOSCUSO;SU;4869;12;5;0;17
111058;SADALI;SU;873;9;5;0;14
111059;SAMASSI;SU;4836;8;9;0;17
111060;SAMATZAI;SU;1558;9;8;0;17
111061;SAN BASILIO;SU;1150;13;4;0;17
111062;SAN GAVINO MONREALE;SU;8160;12;10;0;22
111063;SAN GIOVANNI SUERGIU;SU;5689;12;10;0;22
111064;SAN NICOLO' GERREI;SU;718;9;5;0;14
111065;SAN SPERATE;SU;8398;13;9;0;22
111066;SAN VITO;SU;3488;12;5;0;17
111067;SANLURI;SU;8170;13;9;0;22
111068;SANTADI;SU;3194;10;7;0;17
111069;SANT'ANDREA FRIUS;SU;1717;12;5;0;17
111070;SANT'ANNA ARRESI;SU;2663;10;7;0;17
111071;SANT'ANTIOCO;SU;10756;13;9;0;22
111072;SARDARA;SU;3842;14;3;0;17
111073;SEGARIU;SU;1112;11;6;0;17
111074;SELEGAS;SU;1306;8;9;0;17
111075;SENORBI';SU;4762;13;4;0;17
111076;SERDIANA;SU;2665;15;2;0;17
111077;SERRAMANNA;SU;8640;10;12;0;22
111078;SERRENTI;SU;4581;8;9;0;17
111079;SERRI;SU;629;13;1;0;14
111080;SETZU;SU;133;8;6;0;14
111081;SEUI;SU;1178;11;6;0;17
111082;SEULO;SU;795;8;5;0;13
111083;SIDDI;SU;595;6;8;0;14
111084;SILIQUA;SU;3614;12;5;0;17
111085;SILIUS;SU;1064;13;4;0;17
111086;SIURGUS DONIGALA;SU;1848;12;5;0;17
111087;SOLEMINIS;SU;1854;10;8;0;18
111088;SUELLI;SU;1082;13;4;0;17
111089;TEULADA;SU;3300;12;5;0;17
111090;TRATALIAS;SU;1020;11;6;0;17
111091;TUILI;SU;948;9;8;0;17
111092;TURRI;SU;391;10;4;0;14
111093;USSANA;SU;4023;12;5;0;17
111094;USSARAMANNA;SU;492;5;9;0;14
111095;VALLERMOSA;SU;1810;6;5;0;11
111096;VILLACIDRO;SU;13317;15;7;0;22
111097;VILLAMAR;SU;2472;11;5;0;16
111098;VILLAMASSARGIA;SU;3440;11;6;0;17
111099;VILLANOVA TULO;SU;1019;14;3;0;17
111100;VILLANOVAFORRU;SU;622;7;6;0;13
111101;VILLANOVAFRANCA;SU;1201;14;3;0;17
111102;VILLAPERUCCIO;SU;1010;13;4;0;17
111103;VILLAPUTZU;SU;4509;9;8;0;17
111104;VILLASALTO;SU;989;14;3;0;17
111105;VILLASIMIUS;SU;3705;10;7;0;17
111106;VILLASOR;SU;6599;12;10;0;22
111107;VILLASPECIOSA;SU;2536;12;5;0;17
028001;ABANO TERME;PD;20123;16;6;0;22
098001;ABBADIA CERRETO;LO;275;5;8;0;13
097001;ABBADIA LARIANA;LC;3202;9;8;0;17
052001;ABBADIA SAN SALVATORE;SI;6023;10;7;0;17
095001;ABBASANTA;OR;2594;7;7;0;14
068001;ABBATEGGIO;PE;363;10;3;0;13
015002;ABBIATEGRASSO;MI;32383;23;9;0;32
047023;ABETONE CUTIGLIANO;PT;1902;12;1;0;13
076001;ABRIOLA;PZ;1317;9;4;0;13
088001;ACATE;RG;10581;11;6;0;17
071001;ACCADIA;FG;2182;10;3;0;13
004001;ACCEGLIO;CN;157;12;1;0;13
077001;ACCETTURA;MT;1648;8;5;0;13
066001;ACCIANO;AQ;282;10;3;0;13
057001;ACCUMOLI;RI;547;10;3;0;13
076002;ACERENZA;PZ;2130;10;3;0;13
065001;ACERNO;SA;2500;10;3;0;13
063001;ACERRA;NA;58494;23;6;0;29
087001;ACI BONACCORSI;CT;3525;9;8;0;17
087002;ACI CASTELLO;CT;17975;18;4;0;22
087003;ACI CATENA;CT;28124;17;5;0;22
087005;ACI SANT'ANTONIO;CT;18058;16;6;0;22
087004;ACIREALE;CT;50735;24;8;0;32
060001;ACQUAFONDATA;FR;276;10;3;0;13
078001;ACQUAFORMOSA;CS;1001;7;3;0;10
017001;ACQUAFREDDA;BS;1518;8;5;0;13
041001;ACQUALAGNA;PU;4182;8;8;0;16
019001;ACQUANEGRA CREMONESE;CR;1123;10;2;0;12
020001;ACQUANEGRA SUL CHIESE;MN;2736;6;7;0;13
056001;ACQUAPENDENTE;VT;5304;7;10;0;17
078002;ACQUAPPESA;CS;1743;9;4;0;13
044001;ACQUASANTA TERME;AP;2531;12;5;0;17
055001;ACQUASPARTA;TR;4436;13;4;0;17
070001;ACQUAVIVA COLLECROCE;CB;585;6;7;0;13
094001;ACQUAVIVA D'ISERNIA;IS;377;9;4;0;13
072001;ACQUAVIVA DELLE FONTI;BA;20087;17;5;0;22
044002;ACQUAVIVA PICENA;AP;3692;9;4;0;13
085001;ACQUAVIVA PLATANI;CL;891;10;5;0;15
083107;ACQUEDOLCI;ME;5494;12;6;0;18
006001;ACQUI TERME;AL;19043;16;6;0;22
078003;ACRI;CS;19127;18;4;0;22
060002;ACUTO;FR;1875;13;0;0;13
072002;ADELFIA;BA;16554;11;11;0;22
087006;ADRANO;CT;34110;20;13;0;33
016001;ADRARA SAN MARTINO;BG;2172;7;6;0;13
016002;ADRARA SAN ROCCO;BG;807;8;5;0;13
029001;ADRIA;RO;18781;17;5;0;22
017002;ADRO;BS;7171;10;6;0;16
023001;AFFI;VR;2387;8;5;0;13
058001;AFFILE;RM;1433;10;3;0;13
063002;AFRAGOLA;NA;62198;23;9;0;32
080001;AFRICO;RC;2783;12;5;0;17
033001;AGAZZANO;PC;1975;8;5;0;13
063003;AGEROLA;NA;7666;10;7;0;17
090001;AGGIUS;SS;1405;10;7;0;17
086001;AGIRA;EN;7726;7;10;0;17
047002;AGLIANA;PT;17950;14;8;0;22
005001;AGLIANO TERME;AT;1526;10;3;0;13
001001;AGLIE';TO;2562;7;6;0;13
090062;AGLIENTU;SS;1168;9;5;0;14
028002;AGNA;PD;3152;9;8;0;17
019002;AGNADELLO;CR;3842;10;7;0;17
080002;AGNANA CALABRA;RC;466;8;5;0;13
094002;AGNONE;IS;4703;10;7;0;17
017003;AGNOSINE;BS;1622;11;2;0;13
025001;AGORDO;BL;4085;12;5;0;17
058002;AGOSTA;RM;1704;10;3;0;13
012001;AGRA;VA;407;10;3;0;13
003001;AGRATE CONTURBIA;NO;1520;10;3;0;13
084001;AGRIGENTO;AG;55849;25;9;0;34
065002;AGROPOLI;SA;21173;19;3;0;22
042001;AGUGLIANO;AN;4682;12;5;0;17
024001;AGUGLIARO;VI;1414;12;1;0;13
095002;AIDOMAGGIORE;OR;398;3;7;0;10
086002;AIDONE;EN;4284;6;6;1;13
066002;AIELLI;AQ;1423;8;5;0;13
078004;AIELLO CALABRO;CS;1435;9;4;0;13
030001;AIELLO DEL FRIULI;UD;2174;11;5;0;16
064001;AIELLO DEL SABATO;AV;4007;13;4;0;17
078005;AIETA;CS;765;8;5;0;13
061001;AILANO;CE;1225;9;4;0;13
096001;AILOCHE;BI;314;10;3;0;13
001002;AIRASCA;TO;3660;12;5;0;17
062001;AIROLA;BN;8134;11;6;0;17
008001;AIROLE;IM;363;7;6;0;13
097002;AIRUNO;LC;2832;8;5;0;13
004002;AISONE;CN;205;10;3;0;13
022001;ALA;TN;8801;18;6;0;24
001003;ALA DI STURA;TO;467;9;4;0;13
090002;ALA' DEI SARDI;SS;1789;13;4;0;17
018001;ALAGNA;PV;799;7;6;0;13
002002;ALAGNA VALSESIA;VC;730;10;3;0;13
068002;ALANNO;PE;3390;13;4;0;17
025002;ALANO DI PIAVE;BL;2665;7;6;0;13
009001;ALASSIO;SV;10168;10;12;0;22
060003;ALATRI;FR;27860;17;5;0;22
004003;ALBA;CN;31095;21;11;0;32
067001;ALBA ADRIATICA;TE;12741;11;11;0;22
095003;ALBAGIARA;OR;246;8;6;0;14
015005;ALBAIRATE;MI;4713;9;8;0;17
065003;ALBANELLA;SA;6273;10;7;0;17
076003;ALBANO DI LUCANIA;PZ;1362;11;2;0;13
058003;ALBANO LAZIALE;RM;39674;23;9;0;32
016003;ALBANO SANT'ALESSANDRO;BG;8274;11;6;0;17
002003;ALBANO VERCELLESE;VC;310;8;5;0;13
018002;ALBAREDO ARNABOLDI;PV;225;11;2;0;13
023002;ALBAREDO D'ADIGE;VR;5272;10;7;0;17
014001;ALBAREDO PER SAN MARCO;SO;291;7;6;0;13
034001;ALBARETO;PR;2072;8;5;0;13
004004;ALBARETTO DELLA TORRE;CN;221;8;4;0;12
013003;ALBAVILLA;CO;6360;10;7;0;17
009002;ALBENGA;SV;23435;13;9;0;22
006002;ALBERA LIGURE;AL;314;9;4;0;13
072003;ALBEROBELLO;BA;10331;12;10;0;22
071002;ALBERONA;FG;849;7;5;0;12
013004;ALBESE CON CASSANO;CO;4189;12;5;0;17
024002;ALBETTONE;VI;1982;9;4;0;13
079002;ALBI;CZ;830;0;0;1;1
022002;ALBIANO;TN;1494;11;6;0;17
001004;ALBIANO D'IVREA;TO;1637;7;6;0;13
078006;ALBIDONA;CS;1184;11;2;0;13
028003;ALBIGNASEGO;PD;26642;14;8;0;22
035001;ALBINEA;RE;8788;10;7;0;17
016004;ALBINO;BG;17492;14;8;0;22
013005;ALBIOLO;CO;2725;10;3;0;13
009004;ALBISOLA SUPERIORE;SV;9644;13;9;0;22
009003;ALBISSOLA MARINA;SV;5259;9;8;0;17
012002;ALBIZZATE;VA;5195;10;7;0;17
018003;ALBONESE;PV;533;6;4;0;10
014002;ALBOSAGGIA;SO;3011;13;4;0;17
005002;ALBUGNANO;AT;498;10;2;0;12
018004;ALBUZZANO;PV;3574;13;4;0;17
081001;ALCAMO;TP;44719;22;10;0;32
083001;ALCARA LI FUSI;ME;1742;11;4;0;15
022003;ALDENO;TN;3188;15;8;0;23
021001;ALDINO;BZ;1631;17;3;0;20
095004;ALES;OR;1293;12;5;0;17
006003;ALESSANDRIA;AL;90825;31;11;0;42
078007;ALESSANDRIA DEL CARRETTO;CS;362;12;1;0;13
084002;ALESSANDRIA DELLA ROCCA;AG;2521;11;6;0;17
075002;ALESSANO;LE;6080;8;9;0;17
075003;ALEZIO;LE;5629;9;8;0;17
065004;ALFANO;SA;964;10;3;0;13
066003;ALFEDENA;AQ;925;6;7;0;13
017004;ALFIANELLO;BS;2372;10;3;0;13
006004;ALFIANO NATTA;AL;727;6;7;0;13
039001;ALFONSINE;RA;11506;9;12;0;21
090003;ALGHERO;SS;42458;22;10;0;32
016248;ALGUA;BG;656;11;2;0;13
083002;ALI';ME;685;10;5;0;15
083003;ALI' TERME;ME;2369;9;6;0;15
082001;ALIA;PA;3367;9;8;0;17
077002;ALIANO;MT;893;11;2;0;13
006005;ALICE BEL COLLE;AL;713;9;4;0;13
002004;ALICE CASTELLO;VC;2503;10;3;0;13
061002;ALIFE;CE;7390;10;7;0;17
082002;ALIMENA;PA;1773;8;7;0;15
082003;ALIMINUSA;PA;1089;8;7;0;15
095005;ALLAI;OR;358;9;5;0;14
025003;ALLEGHE;BL;1110;10;2;0;12
007001;ALLEIN;AO;211;10;3;0;13
055002;ALLERONA;TR;1685;8;4;0;12
075004;ALLISTE;LE;6481;10;7;0;17
058004;ALLUMIERE;RM;3778;13;4;0;17
006192;ALLUVIONI PIOVERA;AL;1616;10;3;0;13
016005;ALME';BG;5507;9;8;0;17
016006;ALMENNO SAN BARTOLOMEO;BG;6504;10;7;0;17
016007;ALMENNO SAN SALVATORE;BG;5536;9;8;0;17
001006;ALMESE;TO;6331;8;9;0;17
024003;ALONTE;VI;1593;9;4;0;13
025072;ALPAGO;BL;6617;11;6;0;17
001007;ALPETTE;TO;240;8;3;0;11
001008;ALPIGNANO;TO;16501;14;8;0;22
033002;ALSENO;PC;4672;10;6;0;16
013006;ALSERIO;CO;1303;9;4;0;13
033049;ALTA VAL TIDONE;PC;2906;11;2;0;13
013253;ALTA VALLE INTELVI;CO;3022;11;2;0;13
009005;ALTARE;SV;1932;8;5;0;13
022235;ALTAVALLE;TN;1629;11;9;0;20
064002;ALTAVILLA IRPINA;AV;4004;13;4;0;17
082004;ALTAVILLA MILICIA;PA;8500;10;7;0;17
006007;ALTAVILLA MONFERRATO;AL;399;7;3;0;10
065005;ALTAVILLA SILENTINA;SA;6962;10;7;0;17
024004;ALTAVILLA VICENTINA;VI;11820;14;8;0;22
078008;ALTILIA;CS;673;10;3;0;13
069001;ALTINO;CH;3075;9;4;0;13
024005;ALTISSIMO;VI;2152;6;7;0;13
026001;ALTIVOLE;TV;7015;10;7;0;17
004005;ALTO;CN;142;6;7;0;13
037062;ALTO RENO TERME;BO;6887;11;6;0;17
002170;ALTO SERMENZA;VC;145;7;6;0;13
082005;ALTOFONTE;PA;9903;13;12;0;25
078009;ALTOMONTE;CS;4074;11;6;0;17
046001;ALTOPASCIO;LU;15726;15;7;0;22
022236;ALTOPIANO DELLA VIGOLANA;TN;5140;13;11;0;24
055003;ALVIANO;TR;1396;10;3;0;13
061003;ALVIGNANO;CE;4564;12;5;0;17
060004;ALVITO;FR;2511;8;5;0;13
016008;ALZANO LOMBARDO;BG;13424;12;10;0;22
006008;ALZANO SCRIVIA;AL;348;8;5;0;13
013007;ALZATE BRIANZA;CO;4842;0;0;1;1
065006;AMALFI;SA;4830;10;7;0;17
078010;AMANTEA;CS;13889;14;8;0;22
030002;AMARO;UD;844;7;6;0;13
079003;AMARONI;CZ;1680;6;7;0;13
060005;AMASENO;FR;4095;12;5;0;17
079004;AMATO;CZ;787;10;3;0;13
057002;AMATRICE;RI;2293;11;2;0;13
016009;AMBIVERE;BG;2366;0;0;1;1
022237;AMBLAR-DON;TN;547;11;5;0;16
011001;AMEGLIA;SP;4318;8;9;0;17
055004;AMELIA;TR;11607;10;12;0;22
078011;AMENDOLARA;CS;2760;11;5;0;16
062002;AMOROSI;BN;2641;11;2;0;13
030003;AMPEZZO;UD;920;7;9;0;16
063004;ANACAPRI;NA;6882;9;8;0;17
060006;ANAGNI;FR;20792;17;5;0;22
067002;ANCARANO;TE;1811;9;4;0;13
042002;ANCONA;AN;98402;24;18;0;42
079005;ANDALI;CZ;662;9;4;0;13
022005;ANDALO;TN;1145;13;7;0;20
014003;ANDALO VALTELLINO;SO;597;8;5;0;13
001009;ANDEZENO;TO;2036;9;4;0;13
009006;ANDORA;SV;7261;12;5;0;17
096002;ANDORNO MICCA;BI;3043;12;5;0;17
075005;ANDRANO;LE;4609;12;5;0;17
001010;ANDRATE;TO;474;8;5;0;13
093001;ANDREIS;PN;246;9;4;0;13
064003;ANDRETTA;AV;1688;10;3;0;13
021002;ANDRIANO;BZ;1012;15;5;0;20
090004;ANELA;SS;588;11;1;0;12
017005;ANFO;BS;450;11;2;0;13
012003;ANGERA;VA;5396;9;8;0;17
051001;ANGHIARI;AR;5385;10;7;0;17
023003;ANGIARI;VR;2448;9;4;0;13
017006;ANGOLO TERME;BS;2309;7;5;0;12
065007;ANGRI;SA;33963;20;12;0;32
001011;ANGROGNA;TO;827;6;7;0;13
058005;ANGUILLARA SABAZIA;RM;19167;16;6;0;22
028004;ANGUILLARA VENETA;PD;4156;11;6;0;17
019003;ANNICCO;CR;1983;10;3;0;13
097003;ANNONE DI BRIANZA;LC;2285;4;9;0;13
027001;ANNONE VENETO;VE;3814;11;6;0;17
080003;ANOIA;RC;2048;10;3;0;13
016010;ANTEGNATE;BG;3227;11;6;0;17
021003;ANTERIVO;BZ;399;10;7;0;17
007002;ANTEY-SAINT-ANDRE';AO;542;8;4;0;12
058006;ANTICOLI CORRADO;RM;837;11;2;0;13
005003;ANTIGNANO;AT;949;8;4;0;12
083004;ANTILLO;ME;840;7;8;0;15
080004;ANTONIMINA;RC;1191;10;2;0;12
057003;ANTRODOCO;RI;2356;10;3;0;13
066004;ANVERSA DEGLI ABRUZZI;AQ;303;11;2;0;13
013009;ANZANO DEL PARCO;CO;1755;9;4;0;13
071003;ANZANO DI PUGLIA;FG;1103;12;1;0;13
076004;ANZI;PZ;1553;8;5;0;13
058007;ANZIO;RM;58593;0;0;3;3
037001;ANZOLA DELL'EMILIA;BO;12313;11;10;0;21
007003;AOSTA;AO;33223;22;12;0;34
041002;APECCHIO;PU;1735;11;2;0;13
062003;APICE;BN;5349;9;8;0;17
043002;APIRO;MC;2050;10;3;0;13
062004;APOLLOSA;BN;2485;10;3;0;13
013010;APPIANO GENTILE;CO;7685;9;8;0;17
021004;APPIANO SULLA STRADA DEL VINO;BZ;14741;19;13;0;32
043003;APPIGNANO;MC;4030;10;7;0;17
044005;APPIGNANO DEL TRONTO;AP;1693;9;4;0;13
014004;APRICA;SO;1495;10;3;0;13
008002;APRICALE;IM;628;6;6;0;12
071004;APRICENA;FG;12617;13;9;0;22
078012;APRIGLIANO;CS;2384;11;2;0;13
059001;APRILIA;LT;74119;20;12;0;32
065008;AQUARA;SA;1362;10;3;0;13
008003;AQUILA D'ARROSCIA;IM;147;12;1;0;13
030004;AQUILEIA;UD;3148;12;10;0;22
064004;AQUILONIA;AV;1507;12;1;0;13
060007;AQUINO;FR;4999;13;4;0;17
075006;ARADEO;LE;8928;9;8;0;17
084003;ARAGONA;AG;8860;11;6;0;17
005004;ARAMENGO;AT;565;7;6;0;13
093002;ARBA;PN;1274;10;5;0;15
095006;ARBOREA;OR;3777;12;5;0;17
002006;ARBORIO;VC;830;6;7;0;13
026002;ARCADE;TV;4504;10;6;0;16
060008;ARCE;FR;5430;10;7;0;17
016011;ARCENE;BG;4815;14;3;0;17
042003;ARCEVIA;AN;4286;8;9;0;17
069002;ARCHI;CH;2032;10;3;0;13
053001;ARCIDOSSO;GR;4226;11;6;0;17
058008;ARCINAZZO ROMANO;RM;1236;8;3;0;11
012004;ARCISATE;VA;9915;8;9;0;17
022006;ARCO;TN;17691;25;4;0;29
011002;ARCOLA;SP;10183;8;9;0;17
023004;ARCOLE;VR;6329;8;9;0;17
015007;ARCONATE;MI;6758;10;7;0;17
024006;ARCUGNANO;VI;7717;9;8;0;17
090005;ARDARA;SS;736;8;6;0;14
095007;ARDAULI;OR;780;4;10;0;14
058117;ARDEA;RM;48864;20;12;0;32
014005;ARDENNO;SO;3222;13;4;0;17
016012;ARDESIO;BG;3344;9;8;0;17
080005;ARDORE;RC;4780;0;0;1;1
018005;ARENA PO;PV;1522;11;2;0;13
010001;ARENZANO;GE;11163;14;8;0;22
015009;ARESE;MI;19551;13;9;0;22
051002;AREZZO;AR;96717;33;10;0;43
013011;ARGEGNO;CO;679;11;1;0;12
037002;ARGELATO;BO;9693;8;9;0;17
038001;ARGENTA;FE;20995;12;10;0;22
004006;ARGENTERA;CN;78;8;5;0;13
004007;ARGUELLO;CN;199;12;1;0;13
079007;ARGUSTO;CZ;458;10;3;0;13
069003;ARI;CH;1068;10;3;0;13
064005;ARIANO IRPINO;AV;21240;15;7;0;22
029002;ARIANO NEL POLESINE;RO;4000;9;8;0;17
058009;ARICCIA;RM;18117;13;9;0;22
069004;ARIELLI;CH;1081;11;2;0;13
061004;ARIENZO;CE;5290;11;6;0;17
001012;ARIGNANO;TO;1072;9;2;0;11
091001;ARITZO;NU;1237;15;2;0;17
056002;ARLENA DI CASTRO;VT;827;12;1;0;13
015010;ARLUNO;MI;12275;11;11;0;22
003006;ARMENO;NO;2110;6;7;0;13
076005;ARMENTO;PZ;579;8;5;0;13
008004;ARMO;IM;118;11;2;0;13
007004;ARNAD;AO;1249;11;7;0;18
060009;ARNARA;FR;2199;11;2;0;13
009007;ARNASCO;SV;573;8;5;0;13
075007;ARNESANO;LE;3946;12;5;0;17
003008;ARONA;NO;13675;11;11;0;22
013012;AROSIO;CO;5114;9;7;0;16
062005;ARPAIA;BN;1981;10;3;0;13
062006;ARPAISE;BN;727;10;3;0;13
060010;ARPINO;FR;6799;10;7;0;17
028005;ARQUA' PETRARCA;PD;1817;9;4;0;13
029003;ARQUA' POLESINE;RO;2616;12;1;0;13
044006;ARQUATA DEL TRONTO;AP;1013;12;1;0;13
006009;ARQUATA SCRIVIA;AL;6236;12;5;0;17
028006;ARRE;PD;2097;8;5;0;13
055005;ARRONE;TR;2561;10;3;0;13
012005;ARSAGO SEPRIO;VA;4785;12;5;0;17
025004;ARSIE';BL;2203;9;4;0;13
024007;ARSIERO;VI;3021;12;5;0;17
067003;ARSITA;TE;756;12;1;0;13
058010;ARSOLI;RM;1387;11;2;0;13
030005;ARTA TERME;UD;2056;11;6;0;17
030006;ARTEGNA;UD;2882;11;6;0;17
058011;ARTENA;RM;13666;7;6;0;13
017007;ARTOGNE;BS;3567;11;6;0;17
007005;ARVIER;AO;833;9;5;0;14
090006;ARZACHENA;SS;13328;13;9;0;22
016013;ARZAGO D'ADDA;BG;2744;9;4;0;13
091002;ARZANA;NU;2259;14;4;0;18
063005;ARZANO;NA;32465;21;10;0;31
028007;ARZERGRANDE;PD;4800;11;6;0;17
024008;ARZIGNANO;VI;25094;15;7;0;22
065009;ASCEA;SA;5808;8;9;0;17
052002;ASCIANO;SI;6812;8;9;0;17
044007;ASCOLI PICENO;AP;46085;28;14;0;42
071005;ASCOLI SATRIANO;FG;5925;8;9;0;17
057004;ASCREA;RI;215;7;6;0;13
024009;ASIAGO;VI;6361;10;7;0;17
024010;ASIGLIANO VENETO;VI;844;6;7;0;13
002007;ASIGLIANO VERCELLESE;VC;1382;8;5;0;13
020002;ASOLA;MN;9912;12;10;0;22
026003;ASOLO;TV;8960;12;5;0;17
015011;ASSAGO;MI;9140;9;8;0;17
092003;ASSEMINI;CA;26159;16;15;0;31
054001;ASSISI;PG;27880;13;9;0;22
013013;ASSO;CO;3528;7;10;0;17
095008;ASSOLO;OR;348;10;4;0;14
086003;ASSORO;EN;4868;10;7;0;17
005005;ASTI;AT;73723;29;13;0;42
095009;ASUNI;OR;311;5;9;0;14
066005;ATELETA;AQ;1093;8;5;0;13
076006;ATELLA;PZ;3681;14;3;0;17
065010;ATENA LUCANA;SA;2396;11;2;0;13
069005;ATESSA;CH;10441;10;12;0;22
060011;ATINA;FR;4129;12;4;0;16
065011;ATRANI;SA;802;9;4;0;13
067004;ATRI;TE;10064;13;9;0;22
064006;ATRIPALDA;AV;10455;12;10;0;22
055006;ATTIGLIANO;TR;1969;7;6;0;13
030007;ATTIMIS;UD;1683;9;7;0;16
091003;ATZARA;NU;1026;6;9;0;15
089001;AUGUSTA;SR;34715;25;7;0;32
065012;AULETTA;SA;2150;13;0;0;13
045001;AULLA;MS;10719;12;10;0;22
008005;AURIGO;IM;337;7;6;0;13
025005;AURONZO DI CADORE;BL;3110;9;8;0;17
060012;AUSONIA;FR;2431;10;3;0;13
091004;AUSTIS;NU;772;9;4;0;13
010002;AVEGNO;GE;2519;12;1;0;13
021005;AVELENGO;BZ;811;11;6;0;17
064007;AVELLA;AV;7606;9;10;0;19
064008;AVELLINO;AV;52498;30;12;0;42
016014;AVERARA;BG;173;11;2;0;13
061005;AVERSA;CE;50194;23;9;0;32
073001;AVETRANA;TA;6311;9;8;0;17
066006;AVEZZANO;AQ;41026;23;9;0;32
093004;AVIANO;PN;8866;15;7;0;22
016015;AVIATICO;BG;575;10;3;0;13
001013;AVIGLIANA;TO;12350;13;9;0;22
076007;AVIGLIANO;PZ;10716;10;12;0;22
055033;AVIGLIANO UMBRO;TR;2384;10;3;0;13
022007;AVIO;TN;4108;17;6;0;23
007006;AVISE;AO;299;8;5;0;13
089002;AVOLA;SR;30474;2;1;0;3
006010;AVOLASCA;AL;253;9;4;0;13
007007;AYAS;AO;1359;10;8;0;18
007008;AYMAVILLES;AO;2114;11;7;0;18
001014;AZEGLIO;TO;1240;8;4;0;12
019004;AZZANELLO;CR;615;11;2;0;13
005006;AZZANO D'ASTI;AT;384;8;5;0;13
093005;AZZANO DECIMO;PN;15660;17;15;0;32
017008;AZZANO MELLA;BS;3398;7;6;0;13
016016;AZZANO SAN PAOLO;BG;7596;11;6;0;17
012006;AZZATE;VA;4621;13;4;0;17
012007;AZZIO;VA;755;8;5;0;13
016017;AZZONE;BG;372;8;3;0;11
063006;BACOLI;NA;25410;14;8;0;22
008006;BADALUCCO;IM;1068;7;6;0;13
090081;BADESI;SS;1838;14;3;0;17
023005;BADIA CALAVENA;VR;2581;10;3;0;13
018006;BADIA PAVESE;PV;394;7;6;0;13
029004;BADIA POLESINE;RO;10020;12;10;0;22
051003;BADIA TEDALDA;AR;971;12;1;0;13
021006;BADIA;BZ;3533;17;7;0;24
079008;BADOLATO;CZ;2831;14;3;0;17
080006;BAGALADI;RC;953;9;1;0;10
082006;BAGHERIA;PA;53221;25;7;0;32
039002;BAGNACAVALLO;RA;16398;15;7;0;22
080007;BAGNARA CALABRA;RC;9373;12;10;0;22
039003;BAGNARA DI ROMAGNA;RA;2405;7;6;0;13
018007;BAGNARIA;PV;632;10;3;0;13
030008;BAGNARIA ARSA;UD;3453;12;10;0;22
004008;BAGNASCO;CN;973;12;1;0;13
016018;BAGNATICA;BG;4439;10;7;0;17
046002;BAGNI DI LUCCA;LU;5593;9;8;0;17
048001;BAGNO A RIPOLI;FI;25314;14;8;0;22
040001;BAGNO DI ROMAGNA;FC;5618;10;7;0;17
094003;BAGNOLI DEL TRIGNO;IS;649;9;4;0;13
028008;BAGNOLI DI SOPRA;PD;3386;10;7;0;17
064009;BAGNOLI IRPINO;AV;3029;11;6;0;17
019005;BAGNOLO CREMASCO;CR;4931;11;6;0;17
075008;BAGNOLO DEL SALENTO;LE;1767;8;5;0;13
029005;BAGNOLO DI PO;RO;1235;9;3;0;12
035002;BAGNOLO IN PIANO;RE;9540;7;9;0;16
017009;BAGNOLO MELLA;BS;12494;11;11;0;22
004009;BAGNOLO PIEMONTE;CN;5817;11;6;0;17
020003;BAGNOLO SAN VITO;MN;5850;10;6;0;16
045002;BAGNONE;MS;1722;9;4;0;13
056003;BAGNOREGIO;VT;3482;10;7;0;17
017010;BAGOLINO;BS;3755;12;3;0;15
061006;BAIA E LATINA;CE;2036;11;2;0;13
064010;BAIANO;AV;4515;11;6;0;17
001015;BAIRO;TO;790;5;6;0;11
035003;BAISO;RE;3218;9;8;0;17
008007;BAJARDO;IM;372;8;5;0;13
001016;BALANGERO;TO;3064;10;7;0;17
005007;BALDICHIERI D'ASTI;AT;1090;10;3;0;13
001017;BALDISSERO CANAVESE;TO;530;10;3;0;13
004010;BALDISSERO D'ALBA;CN;1048;9;4;0;13
001018;BALDISSERO TORINESE;TO;3755;9;7;0;16
082007;BALESTRATE;PA;6239;9;8;0;17
009008;BALESTRINO;SV;525;6;7;0;13
097004;BALLABIO;LC;4150;10;7;0;17
001019;BALME;TO;105;6;7;0;13
002008;BALMUCCIA;VC;110;8;3;0;11
002009;BALOCCO;VC;217;8;5;0;13
066007;BALSORANO;AQ;3262;11;6;0;17
076008;BALVANO;PZ;1742;9;4;0;13
006011;BALZOLA;AL;1261;10;3;0;13
090007;BANARI;SS;535;7;5;0;12
001020;BANCHETTE;TO;3085;13;4;0;17
076009;BANZI;PZ;1195;12;1;0;13
028009;BAONE;PD;3067;10;7;0;17
095010;BARADILI;OR;76;9;5;0;14
076010;BARAGIANO;PZ;2534;9;4;0;13
070002;BARANELLO;CB;2496;10;3;0;13
063007;BARANO D'ISCHIA;NA;9975;7;10;0;17
015250;BARANZATE;MI;11762;11;11;0;22
012008;BARASSO;VA;1620;9;4;0;13
095011;BARATILI SAN PIETRO;OR;1211;10;7;0;17
001021;BARBANIA;TO;1570;8;5;0;13
042004;BARBARA;AN;1280;7;3;0;10
024124;BARBARANO MOSSANO;VI;6200;10;7;0;17
056004;BARBARANO ROMANO;VT;990;7;6;0;13
004011;BARBARESCO;CN;609;9;4;0;13
017011;BARBARIGA;BS;2317;10;3;0;13
016019;BARBATA;BG;687;9;4;0;13
048002;BARBERINO DI MUGELLO;FI;10884;11;10;0;21
048054;BARBERINO TAVARNELLE;FI;11906;13;9;0;22
018008;BARBIANELLO;PV;874;10;3;0;13
021007;BARBIANO;BZ;1725;13;7;0;20
028010;BARBONA;PD;608;12;1;0;13
083005;BARCELLONA POZZO DI GOTTO;ME;40029;22;10;0;32
093006;BARCIS;PN;226;9;5;0;14
007009;BARD;AO;108;6;8;0;14
012144;BARDELLO CON MALGESSO E BREGANO;VA;3634;12;5;0;17
034002;BARDI;PR;2043;6;7;0;13
009009;BARDINETO;SV;748;6;7;0;13
023006;BARDOLINO;VR;7003;10;7;0;17
001022;BARDONECCHIA;TO;3044;11;6;0;17
015012;BAREGGIO;MI;17174;14;8;0;22
003012;BARENGO;NO;730;10;3;0;13
095012;BARESSA;OR;568;10;4;0;14
066008;BARETE;AQ;617;9;4;0;13
046003;BARGA;LU;9491;14;8;0;22
010003;BARGAGLI;GE;2558;12;1;0;13
004012;BARGE;CN;7430;11;6;0;17
017012;BARGHE;BS;1138;5;8;0;13
072006;BARI;BA;315948;32;14;0;46
091005;BARI SARDO;NU;3861;13;4;0;17
016020;BARIANO;BG;4252;12;5;0;17
037003;BARICELLA;BO;7021;11;6;0;17
076011;BARILE;PZ;2621;10;3;0;13
066009;BARISCIANO;AQ;1669;10;3;0;13
013015;BARNI;CO;559;11;2;0;13
004013;BAROLO;CN;660;8;5;0;13
001023;BARONE CANAVESE;TO;556;9;4;0;13
065013;BARONISSI;SA;16798;14;8;0;22
086004;BARRAFRANCA;EN;12000;0;0;3;3
066010;BARREA;AQ;718;11;2;0;13
097005;BARZAGO;LC;2406;10;3;0;13
016021;BARZANA;BG;2004;7;6;0;13
097006;BARZANO';LC;4993;11;6;0;17
097007;BARZIO;LC;1260;10;3;0;13
006012;BASALUZZO;AL;2001;11;2;0;13
018009;BASCAPE';PV;1779;7;6;0;13
055007;BASCHI;TR;2590;10;3;0;13
067005;BASCIANO;TE;2349;11;1;0;12
022009;BASELGA DI PINE';TN;5098;21;3;0;24
062007;BASELICE;BN;2121;10;3;0;13
015014;BASIANO;MI;3654;9;8;0;17
083006;BASICO';ME;532;10;5;0;15
015015;BASIGLIO;MI;8040;9;8;0;17
030009;BASILIANO;UD;5233;15;7;0;22
017013;BASSANO BRESCIANO;BS;2333;9;4;0;13
024012;BASSANO DEL GRAPPA;VI;42334;19;13;0;32
056006;BASSANO IN TEVERINA;VT;1251;9;4;0;13
056005;BASSANO ROMANO;VT;4627;9;8;0;17
059002;BASSIANO;LT;1461;10;3;0;13
006013;BASSIGNANA;AL;1556;8;5;0;13
004014;BASTIA MONDOVI';CN;628;8;5;0;13
054002;BASTIA UMBRA;PG;21256;13;9;0;22
018011;BASTIDA PANCARANA;PV;983;8;5;0;13
036001;BASTIGLIA;MO;4126;9;8;0;17
028011;BATTAGLIA TERME;PD;3782;11;6;0;17
004015;BATTIFOLLO;CN;211;10;3;0;13
065014;BATTIPAGLIA;SA;49655;24;9;0;33
018012;BATTUDA;PV;683;10;3;0;13
082008;BAUCINA;PA;1875;10;5;0;15
095013;BAULADU;OR;647;10;4;0;14
091006;BAUNEI;NU;3480;9;8;0;17
012010;BEDERO VALCUVIA;VA;665;9;4;0;13
017014;BEDIZZOLE;BS;12278;14;8;0;22
022011;BEDOLLO;TN;1472;10;9;0;19
034003;BEDONIA;PR;3150;11;6;0;17
016022;BEDULITA;BG;705;9;4;0;13
001024;BEINASCO;TO;17464;12;9;0;21
004016;BEINETTE;CN;3441;10;7;0;17
079009;BELCASTRO;CZ;1227;13;0;0;13
023007;BELFIORE;VR;3271;10;7;0;17
041005;BELFORTE ALL'ISAURO;PU;749;9;4;0;13
043004;BELFORTE DEL CHIENTI;MC;1826;9;4;0;13
006014;BELFORTE MONFERRATO;AL;499;9;4;0;13
018013;BELGIOIOSO;PV;6301;10;6;0;16
076012;BELLA;PZ;4727;11;6;0;17
013250;BELLAGIO;CO;3577;7;10;0;17
097008;BELLANO;LC;3415;11;6;0;17
067006;BELLANTE;TE;6846;9;8;0;17
099001;BELLARIA-IGEA MARINA;RN;19495;16;6;0;22
058012;BELLEGRA;RM;2707;8;4;0;12
004017;BELLINO;CN;95;12;1;0;13
015016;BELLINZAGO LOMBARDO;MI;3809;5;12;0;17
003016;BELLINZAGO NOVARESE;NO;9444;12;5;0;17
065158;BELLIZZI;SA;13295;12;10;0;22
061007;BELLONA;CE;6039;8;9;0;17
065015;BELLOSGUARDO;SA;705;12;1;0;13
025006;BELLUNO;BL;35395;29;13;0;42
078013;BELMONTE CALABRO;CS;1780;10;3;0;13
060013;BELMONTE CASTELLO;FR;693;12;1;0;13
094004;BELMONTE DEL SANNIO;IS;646;1;0;0;1
057005;BELMONTE IN SABINA;RI;645;12;1;0;13
082009;BELMONTE MEZZAGNO;PA;10948;12;10;0;22
087007;BELPASSO;CT;27851;18;4;0;22
078014;BELSITO;CS;892;9;4;0;13
004018;BELVEDERE LANGHE;CN;337;8;5;0;13
078015;BELVEDERE MARITTIMO;CS;8903;10;7;0;17
042005;BELVEDERE OSTRENSE;AN;2096;8;5;0;13
005008;BELVEGLIO;AT;314;8;5;0;13
091007;BELVI';NU;560;8;5;0;13
014006;BEMA;SO;117;9;4;0;13
013021;BENE LARIO;CO;330;11;2;0;13
004019;BENE VAGIENNA;CN;3643;10;7;0;17
080008;BENESTARE;RC;2478;8;2;0;10
090008;BENETUTTI;SS;1726;12;5;0;17
004020;BENEVELLO;CN;467;5;7;0;12
062008;BENEVENTO;BN;56916;27;15;0;42
096003;BENNA;BI;1146;8;5;0;13
037005;BENTIVOGLIO;BO;5700;8;9;0;17
016023;BERBENNO;BG;2431;9;4;0;13
014007;BERBENNO DI VALTELLINA;SO;4078;13;4;0;17
034004;BERCETO;PR;1996;9;4;0;13
090009;BERCHIDDA;SS;2634;10;7;0;17
013022;BEREGAZZO CON FIGLIARO;CO;2794;10;3;0;13
018014;BEREGUARDO;PV;2861;9;2;0;11
006015;BERGAMASCO;AL;709;9;3;0;12
016024;BERGAMO;BG;119476;25;17;0;42
029006;BERGANTINO;RO;2422;7;6;0;13
009010;BERGEGGI;SV;1068;10;3;0;13
004021;BERGOLO;CN;55;11;2;0;13
017015;BERLINGO;BS;2752;8;5;0;13
077003;BERNALDA;MT;11964;13;9;0;22
015019;BERNATE TICINO;MI;2976;10;7;0;17
004022;BERNEZZO;CN;4219;11;6;0;17
040003;BERTINORO;FC;10984;12;10;0;22
030010;BERTIOLO;UD;2376;12;5;0;17
098002;BERTONICO;LO;1071;6;5;0;11
005009;BERZANO DI SAN PIETRO;AT;397;9;4;0;13
006016;BERZANO DI TORTONA;AL;157;9;4;0;13
017016;BERZO DEMO;BS;1525;8;5;0;13
017017;BERZO INFERIORE;BS;2447;8;5;0;13
016025;BERZO SAN FERMO;BG;1428;6;7;0;13
012011;BESANO;VA;2509;7;4;0;11
015022;BESATE;MI;2028;11;1;0;12
022013;BESENELLO;TN;2754;12;8;0;20
033003;BESENZONE;PC;938;7;6;0;13
012012;BESNATE;VA;5475;9;8;0;17
012013;BESOZZO;VA;8756;9;8;0;17
090010;BESSUDE;SS;391;9;4;0;13
033004;BETTOLA;PC;2608;10;3;0;13
054003;BETTONA;PG;4288;13;4;0;17
054004;BEVAGNA;PG;4777;11;6;0;17
011003;BEVERINO;SP;2264;7;6;0;13
023008;BEVILACQUA;VR;1771;7;6;0;13
087008;BIANCAVILLA;CT;23031;12;8;0;20
078016;BIANCHI;CS;1210;9;4;0;13
080009;BIANCO;RC;4188;14;3;0;17
003018;BIANDRATE;NO;1307;8;5;0;13
012014;BIANDRONNO;VA;3167;12;5;0;17
016026;BIANZANO;BG;602;10;3;0;13
002011;BIANZE';VC;1841;9;4;0;13
014008;BIANZONE;SO;1262;7;5;0;12
035004;BIBBIANO;RE;10183;10;7;0;17
051004;BIBBIENA;AR;11806;13;9;0;22
049001;BIBBONA;LI;3172;14;3;0;17
001025;BIBIANA;TO;3378;10;7;0;17
071006;BICCARI;FG;2640;9;4;0;13
030011;BICINICCO;UD;1811;8;8;0;16
095014;BIDONI';OR;128;4;6;0;10
096004;BIELLA;BI;42783;30;12;0;42
017018;BIENNO;BS;3760;12;5;0;17
022015;BIENO;TN;450;12;3;0;15
050001;BIENTINA;PI;8553;9;8;0;17
013023;BINAGO;CO;4824;8;9;0;17
015024;BINASCO;MI;7086;7;10;0;17
072008;BINETTO;BA;2138;9;4;0;13
096005;BIOGLIO;BI;905;10;3;0;13
007010;BIONAZ;AO;218;8;3;0;11
017019;BIONE;BS;1311;10;3;0;13
091008;BIRORI;NU;499;9;5;0;14
064011;BISACCIA;AV;3554;15;2;0;17
082010;BISACQUINO;PA;4190;11;6;0;17
066011;BISEGNA;AQ;207;11;2;0;13
067007;BISENTI;TE;1696;11;2;0;13
078017;BISIGNANO;CS;9614;12;10;0;22
006017;BISTAGNO;AL;1765;8;5;0;13
012015;BISUSCHIO;VA;4250;9;7;0;16
072010;BITETTO;BA;11794;12;10;0;22
072011;BITONTO;BA;53396;23;9;0;32
072012;BITRITTO;BA;11287;12;9;0;21
091009;BITTI;NU;2610;14;3;0;17
084004;BIVONA;AG;3257;9;8;0;17
080010;BIVONGI;RC;1163;9;4;0;13
013024;BIZZARONE;CO;1725;8;5;0;13
022017;BLEGGIO SUPERIORE;TN;1534;11;9;0;20
016027;BLELLO;BG;72;4;7;0;11
056007;BLERA;VT;3003;14;3;0;17
013025;BLESSAGNO;CO;290;6;7;0;13
013026;BLEVIO;CO;1091;9;4;0;13
082082;BLUFI;PA;893;6;9;0;15
028012;BOARA PISANI;PD;2393;9;4;0;13
033005;BOBBIO;PC;3417;13;4;0;17
001026;BOBBIO PELLICE;TO;539;10;3;0;13
003019;BOCA;NO;1131;9;2;0;11
078018;BOCCHIGLIERO;CS;1091;10;3;0;13
002014;BOCCIOLETO;VC;163;7;6;0;13
022018;BOCENAGO;TN;400;11;4;0;15
012016;BODIO LOMNAGO;VA;2231;7;6;0;13
098003;BOFFALORA D'ADDA;LO;1731;9;4;0;13
015026;BOFFALORA SOPRA TICINO;MI;4110;11;6;0;17
010004;BOGLIASCO;GE;4379;8;9;0;17
003021;BOGOGNO;NO;1297;11;2;0;13
009011;BOISSANO;SV;2527;8;5;0;13
070003;BOJANO;CB;7502;11;6;0;17
011004;BOLANO;SP;7451;9;8;0;17
016028;BOLGARE;BG;6521;12;5;0;17
015027;BOLLATE;MI;36166;21;11;0;32
001027;BOLLENGO;TO;2098;6;6;0;12
037006;BOLOGNA;BO;387842;29;18;0;47
068003;BOLOGNANO;PE;1024;7;6;0;13
082011;BOLOGNETTA;PA;4097;0;0;3;3
043005;BOLOGNOLA;MC;145;7;6;0;13
091010;BOLOTANA;NU;2419;10;7;0;17
056008;BOLSENA;VT;3739;14;3;0;17
016029;BOLTIERE;BG;6210;10;7;0;17
003022;BOLZANO NOVARESE;NO;1149;12;1;0;13
024013;BOLZANO VICENTINO;VI;6504;8;9;0;17
021008;BOLZANO;BZ;106601;41;11;0;52
056009;BOMARZO;VT;1692;9;4;0;13
069006;BOMBA;CH;727;9;4;0;13
085002;BOMPENSIERE;CL;513;11;4;0;15
082012;BOMPIETRO;PA;1224;10;5;0;15
036002;BOMPORTO;MO;10144;10;7;0;17
095015;BONARCADO;OR;1519;11;6;0;17
011005;BONASSOLA;SP;816;9;4;0;13
016030;BONATE SOPRA;BG;10242;9;8;0;17
016031;BONATE SOTTO;BG;6629;9;8;0;17
023009;BONAVIGO;VR;2010;9;4;0;13
038003;BONDENO;FE;13872;17;5;0;22
022021;BONDONE;TN;643;8;7;0;15
062009;BONEA;BN;1383;12;1;0;13
070004;BONEFRO;CB;1214;8;5;0;13
019006;BONEMERSE;CR;1464;11;2;0;13
078019;BONIFATI;CS;2624;8;5;0;13
064012;BONITO;AV;2242;10;3;0;13
090011;BONNANARO;SS;930;10;4;0;14
090012;BONO;SS;3356;10;7;0;17
090013;BONORVA;SS;3231;12;5;0;17
004023;BONVICINO;CN;100;10;2;0;12
057006;BORBONA;RI;589;10;3;0;13
025007;BORCA DI CADORE;BL;826;10;3;0;13
030012;BORDANO;UD;710;9;5;0;14
008008;BORDIGHERA;IM;10130;14;8;0;22
019007;BORDOLANO;CR;563;8;5;0;13
034005;BORE;PR;676;11;2;0;13
035005;BORETTO;RE;5252;10;7;0;17
018015;BORGARELLO;PV;2662;9;4;0;13
001028;BORGARO TORINESE;TO;11827;10;12;0;22
082013;BORGETTO;PA;7134;9;8;0;17
008009;BORGHETTO D'ARROSCIA;IM;408;12;1;0;13
006018;BORGHETTO DI BORBERA;AL;1924;10;3;0;13
011006;BORGHETTO DI VARA;SP;878;11;2;0;13
098004;BORGHETTO LODIGIANO;LO;4288;14;3;0;17
009012;BORGHETTO SANTO SPIRITO;SV;4612;8;9;0;17
040004;BORGHI;FC;2882;9;4;0;13
079011;BORGIA;CZ;7218;7;10;0;17
001029;BORGIALLO;TO;582;7;6;0;13
009013;BORGIO VEREZZI;SV;2086;8;5;0;13
046004;BORGO A MOZZANO;LU;6667;10;7;0;17
022238;BORGO CHIESE;TN;1954;13;7;0;20
002015;BORGO D'ALE;VC;2223;7;5;0;12
022252;BORGO D'ANAUNIA;TN;2504;14;5;0;19
016032;BORGO DI TERZO;BG;1147;10;3;0;13
022239;BORGO LARES;TN;720;9;6;0;15
020072;BORGO MANTOVANO;MN;5319;8;9;0;17
041006;BORGO PACE;PU;532;11;2;0;13
018016;BORGO PRIOLO;PV;1319;10;3;0;13
004025;BORGO SAN DALMAZZO;CN;12477;14;8;0;22
017020;BORGO SAN GIACOMO;BS;5388;11;6;0;17
098005;BORGO SAN GIOVANNI;LO;2435;10;3;0;13
048004;BORGO SAN LORENZO;FI;18184;14;8;0;22
006020;BORGO SAN MARTINO;AL;1343;7;6;0;13
018018;BORGO SAN SIRO;PV;953;6;7;0;13
003025;BORGO TICINO;NO;5174;9;7;0;16
037007;BORGO TOSSIGNANO;BO;3240;10;7;0;17
034006;BORGO VAL DI TARO;PR;6723;8;9;0;17
025074;BORGO VALBELLUNA;BL;13457;13;9;0;22
022022;BORGO VALSUGANA;TN;6978;18;6;0;24
057008;BORGO VELINO;RI;940;11;2;0;13
028107;BORGO VENETO;PD;7053;9;8;0;17
002017;BORGO VERCELLI;VC;2260;9;4;0;13
020071;BORGO VIRGILIO;MN;14778;16;6;0;22
020073;BORGOCARBONARA;MN;1901;6;7;0;13
001030;BORGOFRANCO D'IVREA;TO;3555;8;9;0;17
003023;BORGOLAVEZZARO;NO;1956;10;3;0;13
004024;BORGOMALE;CN;386;8;5;0;13
003024;BORGOMANERO;NO;21277;13;9;0;22
008010;BORGOMARO;IM;827;9;3;0;12
001031;BORGOMASINO;TO;773;11;2;0;13
001032;BORGONE SUSA;TO;2151;9;4;0;13
033006;BORGONOVO VAL TIDONE;PC;8026;10;7;0;17
006019;BORGORATTO ALESSANDRINO;AL;536;8;5;0;13
018017;BORGORATTO MORMOROLO;PV;417;7;6;0;13
028013;BORGORICCO;PD;8906;12;5;0;17
057007;BORGOROSE;RI;4247;11;6;0;17
017021;BORGOSATOLLO;BS;9061;9;8;0;17
002016;BORGOSESIA;VC;12189;14;8;0;22
009014;BORMIDA;SV;343;9;4;0;13
014009;BORMIO;SO;3990;7;10;0;17
018019;BORNASCO;PV;2671;10;3;0;13
017022;BORNO;BS;2479;9;4;0;13
095016;BORONEDDU;OR;154;8;6;0;14
091011;BORORE;NU;1994;9;8;0;17
069007;BORRELLO;CH;306;12;1;0;13
096006;BORRIANA;BI;861;7;5;0;12
026004;BORSO DEL GRAPPA;TV;5878;9;8;0;17
091012;BORTIGALI;NU;1205;12;5;0;17
090014;BORTIGIADAS;SS;729;9;5;0;14
090015;BORUTTA;SS;260;10;4;0;14
010005;BORZONASCA;GE;1834;9;4;0;13
095079;BOSA;OR;7539;10;12;0;22
029007;BOSARO;RO;1451;8;4;0;12
023010;BOSCHI SANT'ANNA;VR;1361;9;4;0;13
023011;BOSCO CHIESANUOVA;VR;3560;11;6;0;17
006021;BOSCO MARENGO;AL;2241;5;8;0;13
001033;BOSCONERO;TO;3066;10;7;0;17
063008;BOSCOREALE;NA;26317;16;6;0;22
063009;BOSCOTRECASE;NA;9897;12;10;0;22
004026;BOSIA;CN;170;6;7;0;13
006022;BOSIO;AL;1062;11;2;0;13
097009;BOSISIO PARINI;LC;3312;10;7;0;17
018020;BOSNASCO;PV;636;10;3;0;13
016033;BOSSICO;BG;976;6;7;0;13
004027;BOSSOLASCO;CN;639;9;4;0;13
079012;BOTRICELLO;CZ;5026;12;5;0;17
075009;BOTRUGNO;LE;2613;11;2;0;13
016034;BOTTANUCO;BG;5040;7;10;0;17
017023;BOTTICINO;BS;10706;11;10;0;21
090016;BOTTIDDA;SS;651;10;4;0;14
080011;BOVA;RC;400;8;5;0;13
080013;BOVA MARINA;RC;4080;12;3;0;15
080012;BOVALINO;RC;8672;9;8;0;17
017024;BOVEGNO;BS;2025;11;2;0;13
004028;BOVES;CN;9641;10;7;0;17
017025;BOVEZZO;BS;7356;11;5;0;16
060014;BOVILLE ERNICA;FR;8423;9;8;0;17
071007;BOVINO;FG;2998;11;2;0;13
028014;BOVOLENTA;PD;3449;11;6;0;17
023012;BOVOLONE;VR;16031;16;6;0;22
006023;BOZZOLE;AL;311;12;1;0;13
020007;BOZZOLO;MN;4054;10;7;0;17
004029;BRA;CN;29536;12;9;0;21
016035;BRACCA;BG;724;12;1;0;13
058013;BRACCIANO;RM;18543;13;9;0;22
065016;BRACIGLIANO;SA;5336;11;6;0;17
021009;BRAIES;BZ;691;14;2;0;16
018021;BRALLO DI PREGOLA;PV;514;9;4;0;13
080014;BRANCALEONE;RC;3282;12;4;0;16
017026;BRANDICO;BS;1744;8;5;0;13
001034;BRANDIZZO;TO;8701;8;9;0;17
016036;BRANZI;BG;667;10;3;0;13
017027;BRAONE;BS;682;9;4;0;13
012017;BREBBIA;VA;3155;12;4;0;16
026005;BREDA DI PIAVE;TV;7659;9;8;0;17
024014;BREGANZE;VI;8381;8;9;0;17
013028;BREGNANO;CO;6384;10;7;0;17
016037;BREMBATE;BG;8513;8;9;0;17
016038;BREMBATE DI SOPRA;BG;7920;9;8;0;17
098006;BREMBIO;LO;2692;7;6;0;13
018022;BREME;PV;715;9;4;0;13
024015;BRENDOLA;VI;6639;9;8;0;17
013029;BRENNA;CO;2177;11;2;0;13
021010;BRENNERO;BZ;2308;13;7;0;20
017028;BRENO;BS;4632;14;3;0;17
012019;BRENTA;VA;1735;9;4;0;13
023013;BRENTINO BELLUNO;VR;1350;8;5;0;13
022025;BRENTONICO;TN;4042;15;9;0;24
023014;BRENZONE SUL GARDA;VR;2456;11;2;0;13
035006;BRESCELLO;RE;5623;9;8;0;17
017029;BRESCIA;BS;195906;29;13;0;42
022026;BRESIMO;TN;250;9;5;0;14
018023;BRESSANA BOTTARONE;PV;3443;11;6;0;17
021011;BRESSANONE;BZ;22728;25;9;0;34
024016;BRESSANVIDO;VI;3167;11;6;0;17
015032;BRESSO;MI;26081;15;7;0;22
012020;BREZZO DI BEDERO;VA;1246;10;3;0;13
004030;BRIAGLIA;CN;305;8;5;0;13
001035;BRICHERASIO;TO;4616;10;7;0;17
013030;BRIENNO;CO;335;9;4;0;13
076013;BRIENZA;PZ;3855;15;2;0;17
004031;BRIGA ALTA;CN;40;8;4;0;12
003026;BRIGA NOVARESE;NO;2763;9;8;0;17
006024;BRIGNANO FRASCATA;AL;426;10;3;0;13
016040;BRIGNANO GERA D'ADDA;BG;6098;9;8;0;17
074001;BRINDISI;BR;83317;33;9;0;42
076014;BRINDISI MONTAGNA;PZ;811;8;5;0;13
012021;BRINZIO;VA;773;12;1;0;13
003027;BRIONA;NO;1105;8;5;0;13
017030;BRIONE;BS;737;6;7;0;13
039004;BRISIGHELLA;RA;7189;9;8;0;17
012022;BRISSAGO-VALTRAVAGLIA;VA;1245;8;5;0;13
007011;BRISSOGNE;AO;948;9;5;0;14
068004;BRITTOLI;PE;266;10;3;0;13
097010;BRIVIO;LC;4459;8;9;0;17
060015;BROCCOSTELLA;FR;2684;11;2;0;13
024017;BROGLIANO;VI;4015;12;5;0;17
083007;BROLO;ME;5753;11;6;0;17
004032;BRONDELLO;CN;261;10;3;0;13
018024;BRONI;PV;9585;9;8;0;17
087009;BRONTE;CT;18307;19;3;0;22
021012;BRONZOLO;BZ;2758;14;6;0;20
004033;BROSSASCO;CN;1005;9;4;0;13
001036;BROSSO;TO;394;7;6;0;13
001037;BROZOLO;TO;454;9;4;0;13
028015;BRUGINE;PD;7147;9;8;0;17
011007;BRUGNATO;SP;1284;10;3;0;13
093007;BRUGNERA;PN;9268;14;9;0;23
001038;BRUINO;TO;8489;9;8;0;17
016041;BRUMANO;BG;122;9;4;0;13
013032;BRUNATE;CO;1623;6;7;0;13
012023;BRUNELLO;VA;929;8;5;0;13
021013;BRUNICO;BZ;16995;27;7;0;34
005010;BRUNO;AT;297;10;2;0;12
016042;BRUSAPORTO;BG;5632;10;7;0;17
001039;BRUSASCO;TO;1490;9;4;0;13
063010;BRUSCIANO;NA;15889;10;12;0;22
012024;BRUSIMPIANO;VA;1170;5;8;0;13
096007;BRUSNENGO;BI;1975;7;6;0;13
007012;BRUSSON;AO;861;6;8;0;14
001040;BRUZOLO;TO;1492;9;4;0;13
080015;BRUZZANO ZEFFIRIO;RC;1056;11;2;0;13
015035;BUBBIANO;MI;2460;10;3;0;13
005011;BUBBIO;AT;802;10;2;0;12
089003;BUCCHERI;SR;1765;9;6;0;15
069008;BUCCHIANICO;CH;4980;10;7;0;17
062010;BUCCIANO;BN;2000;10;3;0;13
015036;BUCCINASCO;MI;26912;14;8;0;22
065017;BUCCINO;SA;4661;8;9;0;17
051005;BUCINE;AR;9910;10;11;0;21
090017;BUDDUSO';SS;3659;11;6;0;17
093008;BUDOIA;PN;2492;11;6;0;17
090091;BUDONI;SS;5333;12;10;0;22
037008;BUDRIO;BO;18294;12;9;0;21
047003;BUGGIANO;PT;8746;11;6;0;17
014010;BUGLIO IN MONTE;SO;1967;11;2;0;13
066012;BUGNARA;AQ;1034;9;4;0;13
012025;BUGUGGIATE;VA;3075;8;9;0;17
030013;BUJA;UD;6337;10;12;0;22
097011;BULCIAGO;LC;2866;9;3;0;12
013034;BULGAROGRASSO;CO;4002;12;5;0;17
090018;BULTEI;SS;841;11;3;0;14
090019;BULZI;SS;470;11;3;0;14
065018;BUONABITACOLO;SA;2416;10;3;0;13
062011;BUONALBERGO;BN;1562;8;5;0;13
052003;BUONCONVENTO;SI;3004;12;5;0;17
078020;BUONVICINO;CS;2048;11;3;0;14
084005;BURGIO;AG;2509;8;7;0;15
090020;BURGOS;SS;856;7;6;0;13
001041;BURIASCO;TO;1337;10;3;0;13
001042;BUROLO;TO;1105;8;4;0;12
002021;BURONZO;VC;851;8;4;0;12
095017;BUSACHI;OR;1172;13;4;0;17
010006;BUSALLA;GE;5168;9;8;0;17
001043;BUSANO;TO;1622;8;5;0;13
004034;BUSCA;CN;10127;14;8;0;22
015038;BUSCATE;MI;4633;9;8;0;17
089004;BUSCEMI;SR;968;9;6;0;15
081002;BUSETO PALIZZOLO;TP;2805;8;7;0;15
015040;BUSSERO;MI;8341;8;9;0;17
034007;BUSSETO;PR;6767;9;8;0;17
068005;BUSSI SUL TIRINO;PE;2296;10;3;0;13
070005;BUSSO;CB;1170;8;5;0;13
023015;BUSSOLENGO;VR;20663;13;9;0;22
001044;BUSSOLENO;TO;5652;6;11;0;17
012026;BUSTO ARSIZIO;VA;82754;21;11;0;32
015041;BUSTO GAROLFO;MI;14043;13;9;0;22
085003;BUTERA;CL;4199;10;7;0;17
050002;BUTI;PI;5575;8;9;0;17
023016;BUTTAPIETRA;VR;6987;10;7;0;17
001045;BUTTIGLIERA ALTA;TO;6304;10;7;0;17
005012;BUTTIGLIERA D'ASTI;AT;2496;8;5;0;13
030014;BUTTRIO;UD;3878;14;8;0;22
006025;CABELLA LIGURE;AL;468;9;4;0;13
013035;CABIATE;CO;7405;10;7;0;17
095018;CABRAS;OR;8809;12;10;0;22
082014;CACCAMO;PA;7747;10;6;0;16
012027;CADEGLIANO-VICONAGO;VA;2131;9;4;0;13
035008;CADELBOSCO DI SOPRA;RE;10638;13;9;0;22
033007;CADEO;PC;5983;11;6;0;17
022029;CADERZONE TERME;TN;700;10;4;0;14
028016;CADONEGHE;PD;15773;13;9;0;22
013036;CADORAGO;CO;7931;10;7;0;17
012143;CADREZZATE CON OSMATE;VA;2651;8;5;0;13
026006;CAERANO DI SAN MARCO;TV;7849;8;9;0;17
001046;CAFASSE;TO;3310;12;5;0;17
065019;CAGGIANO;SA;2548;11;2;0;13
041007;CAGLI;PU;8068;11;6;0;17
092009;CAGLIARI;CA;149092;28;16;0;44
013037;CAGLIO;CO;475;10;3;0;13
066013;CAGNANO AMITERNO;AQ;1152;9;4;0;13
071008;CAGNANO VARANO;FG;6648;11;6;0;17
061008;CAIANELLO;CE;1761;10;2;0;12
061009;CAIAZZO;CE;5224;8;6;0;14
021014;CAINES;BZ;388;11;5;0;16
017031;CAINO;BS;2136;7;6;0;13
014011;CAIOLO;SO;1048;9;4;0;13
064013;CAIRANO;AV;275;11;2;0;13
012029;CAIRATE;VA;7729;9;8;0;17
009015;CAIRO MONTENOTTE;SV;12648;14;8;0;22
063011;CAIVANO;NA;36048;0;0;1;1
064014;CALABRITTO;AV;2185;13;0;0;13
025008;CALALZO DI CADORE;BL;1857;9;4;0;13
005013;CALAMANDRANA;AT;1661;6;7;0;13
084006;CALAMONACI;AG;1184;9;6;0;15
090021;CALANGIANUS;SS;3853;10;7;0;17
080016;CALANNA;RC;782;11;2;0;13
086005;CALASCIBETTA;EN;4166;10;7;0;17
066014;CALASCIO;AQ;133;7;6;0;13
087010;CALATABIANO;CT;5167;0;0;3;3
081003;CALATAFIMI SEGESTA;TP;6243;10;7;0;17
056010;CALCATA;VT;915;8;5;0;13
022032;CALCERANICA AL LAGO;TN;1386;12;7;0;19
050003;CALCI;PI;6293;9;8;0;17
077004;CALCIANO;MT;667;12;1;0;13
050004;CALCINAIA;PI;12711;14;8;0;22
016043;CALCINATE;BG;6089;10;7;0;17
017032;CALCINATO;BS;12890;11;11;0;22
016044;CALCIO;BG;5386;9;8;0;17
097012;CALCO;LC;5333;9;8;0;17
021015;CALDARO SULLA STRADA DEL VINO;BZ;8107;17;7;0;24
043006;CALDAROLA;MC;1639;12;1;0;13
037009;CALDERARA DI RENO;BO;13434;13;8;0;21
022033;CALDES;TN;1087;9;8;0;17
023017;CALDIERO;VR;7896;9;8;0;17
024018;CALDOGNO;VI;11321;11;11;0;22
022034;CALDONAZZO;TN;3900;15;9;0;24
033008;CALENDASCO;PC;2397;8;5;0;13
048005;CALENZANO;FI;18041;13;9;0;22
034008;CALESTANO;PR;2060;8;5;0;13
011008;CALICE AL CORNOVIGLIO;SP;1053;8;4;0;12
009016;CALICE LIGURE;SV;1692;10;3;0;13
075010;CALIMERA;LE;6777;9;8;0;17
064015;CALITRI;AV;4278;12;5;0;17
009017;CALIZZANO;SV;1423;8;4;0;12
096008;CALLABIANA;BI;147;9;4;0;13
022035;CALLIANO;TN;2020;12;8;0;20
005014;CALLIANO MONFERRATO;AT;1209;9;4;0;13
097013;CALOLZIOCORTE;LC;13507;12;10;0;22
078021;CALOPEZZATI;CS;1301;10;3;0;13
005015;CALOSSO;AT;1146;10;3;0;13
078022;CALOVETO;CS;1131;13;0;0;13
084007;CALTABELLOTTA;AG;3238;11;6;0;17
087011;CALTAGIRONE;CT;36058;26;7;0;33
085004;CALTANISSETTA;CL;59245;16;14;0;30
082015;CALTAVUTURO;PA;3612;10;6;0;16
003030;CALTIGNAGA;NO;2504;8;5;0;13
029008;CALTO;RO;659;8;5;0;13
024019;CALTRANO;VI;2527;9;4;0;13
016046;CALUSCO D'ADDA;BG;8231;10;7;0;17
001047;CALUSO;TO;7388;12;5;0;17
017033;CALVAGESE DELLA RIVIERA;BS;3644;10;7;0;17
065020;CALVANICO;SA;1397;13;0;0;13
019009;CALVATONE;CR;1174;7;6;0;13
076015;CALVELLO;PZ;1764;9;4;0;13
024020;CALVENE;VI;1289;11;2;0;13
016047;CALVENZANO;BG;4279;10;7;0;17
076016;CALVERA;PZ;358;11;2;0;13
062012;CALVI;BN;2515;13;0;0;13
055008;CALVI DELL'UMBRIA;TR;1697;10;3;0;13
061010;CALVI RISORTA;CE;5518;9;8;0;17
018025;CALVIGNANO;PV;106;9;4;0;13
015042;CALVIGNASCO;MI;1222;8;5;0;13
017034;CALVISANO;BS;8375;10;7;0;17
063012;CALVIZZANO;NA;12397;14;8;0;22
006026;CAMAGNA MONFERRATO;AL;468;9;4;0;13
046005;CAMAIORE;LU;31821;19;13;0;32
096009;CAMANDONA;BI;311;11;2;0;13
084008;CAMASTRA;AG;1947;3;2;1;6
015044;CAMBIAGO;MI;7118;11;6;0;17
001048;CAMBIANO;TO;5900;8;9;0;17
096010;CAMBURZANO;BI;1120;9;4;0;13
004035;CAMERANA;CN;575;8;5;0;13
042006;CAMERANO;AN;7107;10;7;0;17
005016;CAMERANO CASASCO;AT;407;10;3;0;13
016048;CAMERATA CORNELLO;BG;558;8;5;0;13
058014;CAMERATA NUOVA;RM;410;6;7;0;13
042007;CAMERATA PICENA;AN;2506;10;3;0;13
003032;CAMERI;NO;10660;13;9;0;22
043007;CAMERINO;MC;6268;9;8;0;17
065021;CAMEROTA;SA;6882;10;7;0;17
061011;CAMIGLIANO;CE;1993;11;2;0;13
080017;CAMINI;RC;808;11;2;0;13
006027;CAMINO;AL;736;8;5;0;13
030015;CAMINO AL TAGLIAMENTO;UD;1544;5;10;0;15
019010;CAMISANO;CR;1237;9;4;0;13
024021;CAMISANO VICENTINO;VI;11165;14;8;0;22
084009;CAMMARATA;AG;5920;12;5;0;17
010007;CAMOGLI;GE;5022;12;5;0;17
065022;CAMPAGNA;SA;16562;18;4;0;22
027002;CAMPAGNA LUPIA;VE;7128;10;7;0;17
058015;CAMPAGNANO DI ROMA;RM;11092;13;9;0;22
053002;CAMPAGNATICO;GR;2335;10;3;0;13
019011;CAMPAGNOLA CREMASCA;CR;662;10;3;0;13
035009;CAMPAGNOLA EMILIA;RE;5500;9;8;0;17
078023;CAMPANA;CS;1509;9;4;0;13
035010;CAMPEGINE;RE;5292;10;6;0;16
054005;CAMPELLO SUL CLITUNNO;PG;2347;8;4;0;12
002025;CAMPERTOGNO;VC;221;6;7;0;13
048006;CAMPI BISENZIO;FI;47541;24;8;0;32
075011;CAMPI SALENTINA;LE;9885;12;10;0;22
096086;CAMPIGLIA CERVO;BI;521;7;6;0;13
024022;CAMPIGLIA DEI BERICI;VI;1669;8;5;0;13
049002;CAMPIGLIA MARITTIMA;LI;12538;9;13;0;22
001049;CAMPIGLIONE FENILE;TO;1330;10;3;0;13
013040;CAMPIONE D'ITALIA;CO;1748;10;3;0;13
022036;CAMPITELLO DI FASSA;TN;707;13;3;0;16
067008;CAMPLI;TE;6630;10;7;0;17
080018;CAMPO CALABRO;RC;4449;12;5;0;17
066015;CAMPO DI GIOVE;AQ;750;10;3;0;13
021016;CAMPO DI TRENS;BZ;2679;17;3;0;20
010008;CAMPO LIGURE;GE;2790;11;6;0;17
049003;CAMPO NELL'ELBA;LI;4706;12;5;0;17
028020;CAMPO SAN MARTINO;PD;5652;12;5;0;17
021017;CAMPO TURES;BZ;5685;16;8;0;24
070006;CAMPOBASSO;CB;47587;21;16;0;37
084010;CAMPOBELLO DI LICATA;AG;9175;0;0;1;1
081004;CAMPOBELLO DI MAZARA;TP;11463;12;10;0;22
070007;CAMPOCHIARO;CB;595;9;4;0;13
028017;CAMPODARSEGO;PD;14943;15;7;0;22
022037;CAMPODENNO;TN;1512;16;4;0;20
059003;CAMPODIMELE;LT;561;1;0;0;1
070008;CAMPODIPIETRA;CB;2435;9;4;0;13
014012;CAMPODOLCINO;SO;928;9;4;0;13
028018;CAMPODORO;PD;2616;9;4;0;13
082016;CAMPOFELICE DI FITALIA;PA;467;12;3;0;15
082017;CAMPOFELICE DI ROCCELLA;PA;7605;10;8;0;18
082018;CAMPOFIORITO;PA;1179;9;6;0;15
030016;CAMPOFORMIDO;UD;7857;14;8;0;22
085005;CAMPOFRANCO;CL;2716;10;7;0;17
036003;CAMPOGALLIANO;MO;8578;9;8;0;17
062013;CAMPOLATTARO;BN;972;8;5;0;13
060016;CAMPOLI APPENNINO;FR;1610;10;3;0;13
062014;CAMPOLI DEL MONTE TABURNO;BN;1594;13;0;0;13
070009;CAMPOLIETO;CB;800;9;4;0;13
027003;CAMPOLONGO MAGGIORE;VE;10725;11;11;0;22
030138;CAMPOLONGO TAPOGLIANO;UD;1132;12;5;0;17
076017;CAMPOMAGGIORE;PZ;730;10;3;0;13
070010;CAMPOMARINO;CB;7648;11;6;0;17
010009;CAMPOMORONE;GE;6482;8;9;0;17
027004;CAMPONOGARA;VE;13005;14;8;0;22
065023;CAMPORA;SA;325;9;4;0;13
082019;CAMPOREALE;PA;3015;8;9;0;17
046006;CAMPORGIANO;LU;2041;9;4;0;13
008011;CAMPOROSSO;IM;5577;9;8;0;17
043008;CAMPOROTONDO DI FIASTRONE;MC;501;7;5;0;12
087012;CAMPOROTONDO ETNEO;CT;5213;9;9;0;18
028019;CAMPOSAMPIERO;PD;11867;11;11;0;22
063013;CAMPOSANO;NA;5102;9;8;0;17
036004;CAMPOSANTO;MO;3261;12;5;0;17
018026;CAMPOSPINOSO;PV;1091;10;3;0;13
066016;CAMPOTOSTO;AQ;473;7;6;0;13
037010;CAMUGNANO;BO;1804;9;4;0;13
022038;CANAL SAN BOVO;TN;1472;9;8;0;17
004037;CANALE;CN;5514;11;6;0;17
025023;CANALE D'AGORDO;BL;1069;9;3;0;12
058016;CANALE MONTERANO;RM;4156;13;4;0;17
029009;CANARO;RO;2599;11;2;0;13
022039;CANAZEI;TN;1878;13;7;0;20
076018;CANCELLARA;PZ;1167;8;5;0;13
061012;CANCELLO ED ARNONE;CE;5511;9;8;0;17
029010;CANDA;RO;855;9;4;0;13
071009;CANDELA;FG;2540;11;2;0;13
096012;CANDELO;BI;7271;8;9;0;17
001050;CANDIA CANAVESE;TO;1209;7;6;0;13
018027;CANDIA LOMELLINA;PV;1445;8;5;0;13
028021;CANDIANA;PD;2214;10;3;0;13
064016;CANDIDA;AV;1104;8;5;0;13
080019;CANDIDONI;RC;418;13;0;0;13
001051;CANDIOLO;TO;5610;11;6;0;17
015046;CANEGRATE;MI;12499;14;8;0;22
005017;CANELLI;AT;10181;13;9;0;22
056011;CANEPINA;VT;2913;14;3;0;17
093009;CANEVA;PN;6254;15;7;0;22
084011;CANICATTI';AG;34588;25;7;0;32
089005;CANICATTINI BAGNI;SR;6619;9;8;0;17
056012;CANINO;VT;5089;10;7;0;17
001052;CANISCHIO;TO;286;8;5;0;13
066017;CANISTRO;AQ;911;10;3;0;13
078024;CANNA;CS;649;9;4;0;13
065024;CANNALONGA;SA;981;10;3;0;13
054006;CANNARA;PG;4198;9;8;0;17
018029;CANNETO PAVESE;PV;1306;8;5;0;13
020008;CANNETO SULL'OGLIO;MN;4237;12;5;0;17
075012;CANNOLE;LE;1631;7;6;0;13
080020;CANOLO;RC;703;10;1;0;11
016049;CANONICA D'ADDA;BG;4235;7;10;0;17
069010;CANOSA SANNITA;CH;1288;13;0;0;13
004038;CANOSIO;CN;79;7;6;0;13
035018;CANOSSA;RE;3708;12;5;0;17
066018;CANSANO;AQ;205;10;3;0;13
057009;CANTALICE;RI;2457;9;4;0;13
001053;CANTALUPA;TO;2602;8;5;0;13
057010;CANTALUPO IN SABINA;RI;1642;8;5;0;13
006028;CANTALUPO LIGURE;AL;454;10;3;0;13
094005;CANTALUPO NEL SANNIO;IS;725;11;2;0;13
005018;CANTARANA;AT;987;9;4;0;13
012030;CANTELLO;VA;4726;8;9;0;17
058017;CANTERANO;RM;356;0;0;1;1
041008;CANTIANO;PU;2026;7;6;0;13
001054;CANTOIRA;TO;596;9;4;0;13
013041;CANTU';CO;39382;25;7;0;32
067009;CANZANO;TE;1794;8;5;0;13
013042;CANZO;CO;5111;9;8;0;17
027005;CAORLE;VE;11155;14;8;0;22
033010;CAORSO;PC;4701;11;6;0;17
065025;CAPACCIO PAESTUM;SA;22331;19;3;0;22
082020;CAPACI;PA;11333;13;9;0;22
053003;CAPALBIO;GR;3887;10;7;0;17
050005;CAPANNOLI;PI;6430;10;7;0;17
046007;CAPANNORI;LU;46390;20;12;0;32
058018;CAPENA;RM;10733;2;3;0;5
019012;CAPERGNANICA;CR;2148;9;4;0;13
066019;CAPESTRANO;AQ;840;9;4;0;13
013043;CAPIAGO INTIMIANO;CO;5474;9;8;0;17
066020;CAPISTRELLO;AQ;4875;8;9;0;17
066021;CAPITIGNANO;AQ;619;10;3;0;13
083008;CAPIZZI;ME;2888;10;5;0;15
016050;CAPIZZONE;BG;1206;11;2;0;13
083009;CAPO D'ORLANDO;ME;13102;15;7;0;22
017035;CAPO DI PONTE;BS;2327;8;5;0;13
056013;CAPODIMONTE;VT;1655;10;2;0;12
061013;CAPODRISE;CE;10065;0;0;1;1
049004;CAPOLIVERI;LI;3878;15;2;0;17
051006;CAPOLONA;AR;5244;11;6;0;17
066022;CAPORCIANO;AQ;206;10;3;0;13
064017;CAPOSELE;AV;3271;14;3;0;17
092011;CAPOTERRA;CA;23235;18;9;0;27
017036;CAPOVALLE;BS;345;11;2;0;13
066023;CAPPADOCIA;AQ;563;11;2;0;13
019013;CAPPELLA CANTONE;CR;543;8;5;0;13
019014;CAPPELLA DE' PICENARDI;CR;416;9;2;0;11
026007;CAPPELLA MAGGIORE;TV;4657;10;7;0;17
068006;CAPPELLE SUL TAVO;PE;4017;12;5;0;17
094006;CAPRACOTTA;IS;815;12;1;0;13
048008;CAPRAIA E LIMITE;FI;7881;12;5;0;17
049005;CAPRAIA ISOLA;LI;378;7;6;0;13
019015;CAPRALBA;CR;2267;9;4;0;13
056014;CAPRANICA;VT;6377;8;9;0;17
058019;CAPRANICA PRENESTINA;RM;309;12;1;0;13
075013;CAPRARICA DI LECCE;LE;2322;8;5;0;13
056015;CAPRAROLA;VT;5218;9;8;0;17
004039;CAPRAUNA;CN;96;11;2;0;13
051007;CAPRESE MICHELANGELO;AR;1355;9;4;0;13
063014;CAPRI;NA;6827;11;6;0;17
083010;CAPRI LEONE;ME;4354;9;8;0;17
022040;CAPRIANA;TN;588;8;7;0;15
017037;CAPRIANO DEL COLLE;BS;4633;11;5;0;16
006029;CAPRIATA D'ORBA;AL;1777;10;3;0;13
016051;CAPRIATE SAN GERVASIO;BG;8190;11;6;0;17
061014;CAPRIATI A VOLTURNO;CE;1469;6;7;0;13
001055;CAPRIE;TO;2060;11;2;0;13
064018;CAPRIGLIA IRPINA;AV;2263;9;4;0;13
005019;CAPRIGLIO;AT;306;9;2;0;11
096013;CAPRILE;BI;196;7;5;0;12
016052;CAPRINO BERGAMASCO;BG;3039;11;6;0;17
023018;CAPRINO VERONESE;VR;8604;9;8;0;17
017038;CAPRIOLO;BS;9431;10;7;0;17
031001;CAPRIVA DEL FRIULI;GO;1617;8;7;0;15
061015;CAPUA;CE;17645;14;8;0;22
072014;CAPURSO;BA;15275;14;8;0;22
080021;CARAFFA DEL BIANCO;RC;463;10;3;0;13
079017;CARAFFA DI CATANZARO;CZ;1739;12;1;0;13
004040;CARAGLIO;CN;6755;9;8;0;17
004041;CARAMAGNA PIEMONTE;CN;3072;12;5;0;17
068007;CARAMANICO TERME;PE;1796;13;0;0;13
071010;CARAPELLE;FG;6782;9;8;0;17
066024;CARAPELLE CALVISIO;AQ;78;11;2;0;13
010010;CARASCO;GE;3770;11;2;0;13
044010;CARASSAI;AP;981;9;3;0;12
013044;CARATE URIO;CO;1101;11;2;0;13
016053;CARAVAGGIO;BG;16109;12;10;0;22
012031;CARAVATE;VA;2551;11;2;0;13
001056;CARAVINO;TO;901;10;3;0;13
008012;CARAVONICA;IM;262;11;2;0;13
056016;CARBOGNANO;VT;1934;10;3;0;13
018030;CARBONARA AL TICINO;PV;1428;10;3;0;13
063015;CARBONARA DI NOLA;NA;2482;13;0;0;13
006030;CARBONARA SCRIVIA;AL;1104;9;4;0;13
013045;CARBONATE;CO;2896;9;4;0;13
076019;CARBONE;PZ;541;9;4;0;13
026008;CARBONERA;TV;11277;15;7;0;22
009018;CARCARE;SV;5254;10;7;0;17
028022;CARCERI;PD;1492;8;5;0;13
002029;CARCOFORO;VC;72;9;3;0;12
012032;CARDANO AL CAMPO;VA;14728;12;9;0;21
004042;CARDE';CN;1143;7;6;0;13
091103;CARDEDU;NU;1927;14;3;0;17
080022;CARDETO;RC;1361;11;2;0;13
079018;CARDINALE;CZ;1856;8;5;0;13
063016;CARDITO;NA;21599;17;5;0;22
046008;CAREGGINE;LU;509;8;5;0;13
001057;CAREMA;TO;739;9;3;0;12
097014;CARENNO;LC;1382;8;5;0;13
006031;CARENTINO;AL;321;6;6;0;12
080023;CARERI;RC;2135;10;3;0;13
002030;CARESANA;VC;1057;7;6;0;13
002031;CARESANABLOT;VC;1088;8;5;0;13
006032;CAREZZANO;AL;426;8;3;0;11
090022;CARGEGHE;SS;593;10;4;0;14
078025;CARIATI;CS;7476;10;7;0;17
064019;CARIFE;AV;1289;9;4;0;13
001058;CARIGNANO;TO;9052;11;6;0;17
013046;CARIMATE;CO;4429;12;5;0;17
061016;CARINARO;CE;7121;10;7;0;17
082021;CARINI;PA;39275;24;8;0;32
061017;CARINOLA;CE;7216;11;5;0;16
002032;CARISIO;VC;772;8;2;0;10
022042;CARISOLO;TN;948;10;4;0;14
071011;CARLANTINO;FG;826;10;3;0;13
013047;CARLAZZO;CO;3144;10;3;0;13
030018;CARLINO;UD;2702;10;7;0;17
079020;CARLOPOLI;CZ;1406;11;2;0;13
001059;CARMAGNOLA;TO;28313;14;8;0;22
075014;CARMIANO;LE;11720;11;11;0;22
028023;CARMIGNANO DI BRENTA;PD;7478;9;8;0;17
012033;CARNAGO;VA;6600;9;8;0;17
016055;CAROBBIO DEGLI ANGELI;BG;4811;11;6;0;17
078026;CAROLEI;CS;3155;11;6;0;17
016056;CARONA;BG;286;9;4;0;13
083011;CARONIA;ME;3093;9;8;0;17
012034;CARONNO PERTUSELLA;VA;18116;13;9;0;22
012035;CARONNO VARESINO;VA;4786;0;0;1;1
073002;CAROSINO;TA;6663;10;7;0;17
074002;CAROVIGNO;BR;16925;17;6;0;23
094007;CAROVILLI;IS;1273;10;3;0;13
033011;CARPANETO PIACENTINO;PC;7649;8;9;0;17
078027;CARPANZANO;CS;210;11;2;0;13
041009;CARPEGNA;PU;1634;11;2;0;13
017039;CARPENEDOLO;BS;12977;16;6;0;22
006033;CARPENETO;AL;911;9;4;0;13
036005;CARPI;MO;71402;17;15;0;32
015050;CARPIANO;MI;4150;9;8;0;17
075015;CARPIGNANO SALENTINO;LE;3678;14;3;0;17
003036;CARPIGNANO SESIA;NO;2470;11;2;0;13
035011;CARPINETI;RE;3884;11;6;0;17
068008;CARPINETO DELLA NORA;PE;556;9;4;0;13
058020;CARPINETO ROMANO;RM;4094;11;6;0;17
069011;CARPINETO SINELLO;CH;530;11;2;0;13
071012;CARPINO;FG;3881;14;3;0;17
094008;CARPINONE;IS;1042;11;2;0;13
045003;CARRARA;MS;60185;18;13;0;31
024024;CARRE';VI;3500;12;5;0;17
006034;CARREGA LIGURE;AL;88;12;1;0;13
011009;CARRO;SP;514;11;2;0;13
011010;CARRODANO;SP;477;11;2;0;13
006035;CARROSIO;AL;494;10;3;0;13
004043;CARRU';CN;4382;11;6;0;17
066025;CARSOLI;AQ;5067;7;10;0;17
024025;CARTIGLIANO;VI;3711;11;6;0;17
004044;CARTIGNANO;CN;175;7;5;0;12
041010;CARTOCETO;PU;7966;8;9;0;17
006036;CARTOSIO;AL;720;10;3;0;13
028026;CARTURA;PD;4582;9;8;0;17
015051;CARUGATE;MI;15664;14;8;0;22
013048;CARUGO;CO;6569;11;6;0;17
069012;CARUNCHIO;CH;579;12;1;0;13
016057;CARVICO;BG;4646;9;8;0;17
022043;CARZANO;TN;518;9;7;0;16
070011;CASACALENDA;CB;1880;9;4;0;13
069013;CASACANDITELLA;CH;1170;7;6;0;13
061018;CASAGIOVE;CE;13116;13;8;0;21
006037;CASAL CERMELLI;AL;1182;8;5;0;13
061019;CASAL DI PRINCIPE;CE;21244;18;4;0;22
065028;CASAL VELINO;SA;5343;14;3;0;17
069014;CASALANGUIDA;CH;837;9;4;0;13
060017;CASALATTICO;FR;544;11;2;0;13
003037;CASALBELTRAME;NO;991;8;5;0;13
069015;CASALBORDINO;CH;5830;10;7;0;17
064020;CASALBORE;AV;1608;11;2;0;13
001060;CASALBORGONE;TO;1855;5;8;0;13
065026;CASALBUONO;SA;1065;10;3;0;13
019016;CASALBUTTANO ED UNITI;CR;3652;9;8;0;17
070012;CASALCIPRANO;CB;470;9;4;0;13
062015;CASALDUNI;BN;1238;9;4;0;13
019017;CASALE CREMASCO VIDOLASCO;CR;1829;12;1;0;13
028027;CASALE DI SCODOSIA;PD;4701;12;5;0;17
012036;CASALE LITTA;VA;2729;8;5;0;13
050006;CASALE MARITTIMO;PI;1076;7;5;0;12
006039;CASALE MONFERRATO;AL;32399;22;10;0;32
026009;CASALE SUL SILE;TV;13160;13;9;0;22
037011;CASALECCHIO DI RENO;BO;35784;18;13;0;31
006038;CASALEGGIO BOIRO;AL;370;10;2;0;12
003039;CASALEGGIO NOVARA;NO;905;6;7;0;13
023019;CASALEONE;VR;5551;9;7;0;16
019018;CASALETTO CEREDANO;CR;1151;9;4;0;13
019019;CASALETTO DI SOPRA;CR;515;11;2;0;13
098008;CASALETTO LODIGIANO;LO;2959;7;6;0;13
065027;CASALETTO SPARTANO;SA;1303;10;3;0;13
019020;CASALETTO VAPRIO;CR;1771;6;6;0;12
037012;CASALFIUMANESE;BO;3367;13;4;0;17
035012;CASALGRANDE;RE;18857;13;9;0;22
004045;CASALGRASSO;CN;1412;11;2;0;13
078156;CASALI DEL MANCO;CS;9596;8;9;0;17
069016;CASALINCONTRADA;CH;3011;10;6;0;16
003040;CASALINO;NO;1523;10;3;0;13
019021;CASALMAGGIORE;CR;14974;13;9;0;22
098009;CASALMAIOCCO;LO;3208;11;5;0;16
019022;CASALMORANO;CR;1621;9;4;0;13
020010;CASALMORO;MN;2208;10;3;0;13
006040;CASALNOCETO;AL;969;7;6;0;13
063017;CASALNUOVO DI NAPOLI;NA;47428;23;7;0;30
071013;CASALNUOVO MONTEROTARO;FG;1379;10;3;0;13
020011;CASALOLDO;MN;2654;6;7;0;13
098010;CASALPUSTERLENGO;LO;15399;13;9;0;22
020012;CASALROMANO;MN;1483;9;4;0;13
028028;CASALSERUGO;PD;5390;9;8;0;17
061020;CASALUCE;CE;9543;15;7;0;22
071014;CASALVECCHIO DI PUGLIA;FG;1704;11;2;0;13
083012;CASALVECCHIO SICULO;ME;735;10;5;0;15
060018;CASALVIERI;FR;2438;11;2;0;13
003041;CASALVOLONE;NO;875;10;3;0;13
012037;CASALZUIGNO;VA;1362;10;3;0;13
063018;CASAMARCIANO;NA;3048;9;8;0;17
072015;CASAMASSIMA;BA;19404;16;6;0;22
063019;CASAMICCIOLA TERME;NA;7715;10;7;0;17
063020;CASANDRINO;NA;13363;0;0;1;1
002033;CASANOVA ELVO;VC;222;8;3;0;11
009019;CASANOVA LERRONE;SV;737;12;1;0;13
018031;CASANOVA LONATI;PV;453;8;5;0;13
058021;CASAPE;RM;643;11;2;0;13
061103;CASAPESENNA;CE;6869;10;7;0;17
096014;CASAPINTA;BI;397;9;4;0;13
057011;CASAPROTA;RI;691;9;4;0;13
061021;CASAPULLA;CE;8374;8;9;0;17
075016;CASARANO;LE;19372;16;6;0;22
097015;CASARGO;LC;837;8;5;0;13
015055;CASARILE;MI;4020;13;4;0;17
093010;CASARSA DELLA DELIZIA;PN;8240;13;10;0;23
010011;CASARZA LIGURE;GE;6729;9;7;0;16
006041;CASASCO;AL;121;9;4;0;13
097016;CASATENOVO;LC;13183;14;8;0;22
018032;CASATISMA;PV;866;10;3;0;13
063021;CASAVATORE;NA;18282;15;7;0;22
016058;CASAZZA;BG;3838;12;5;0;17
054007;CASCIA;PG;2979;9;8;0;17
012038;CASCIAGO;VA;3617;14;3;0;17
050040;CASCIANA TERME LARI;PI;12160;12;8;0;20
050008;CASCINA;PI;44865;20;12;0;32
001061;CASCINETTE D'IVREA;TO;1524;10;3;0;13
018033;CASEI GEROLA;PV;2379;9;4;0;13
001062;CASELETTE;TO;3034;11;2;0;13
010012;CASELLA;GE;3125;11;6;0;17
065029;CASELLE IN PITTARI;SA;1864;11;2;0;13
098011;CASELLE LANDI;LO;1497;9;4;0;13
098012;CASELLE LURANI;LO;3038;13;4;0;17
001063;CASELLE TORINESE;TO;13834;15;7;0;22
061022;CASERTA;CE;73037;32;10;0;42
026010;CASIER;TV;11356;12;10;0;22
080024;CASIGNANA;RC;707;12;1;0;13
035013;CASINA;RE;4510;9;8;0;17
016059;CASIRATE D'ADDA;BG;4069;7;10;0;17
013052;CASLINO D'ERBA;CO;1644;6;7;0;13
013053;CASNATE CON BERNATE;CO;5011;12;5;0;17
016060;CASNIGO;BG;3075;10;7;0;17
063022;CASOLA DI NAPOLI;NA;3663;9;8;0;17
045004;CASOLA IN LUNIGIANA;MS;969;6;7;0;13
039005;CASOLA VALSENIO;RA;2541;11;2;0;13
052004;CASOLE D'ELSA;SI;3716;11;6;0;17
069017;CASOLI;CH;5230;9;8;0;17
018034;CASORATE PRIMO;PV;8766;10;7;0;17
012039;CASORATE SEMPIONE;VA;5671;9;8;0;17
015058;CASOREZZO;MI;5535;12;5;0;17
063023;CASORIA;NA;74394;21;11;0;32
005020;CASORZO MONFERRATO;AT;610;8;5;0;13
057012;CASPERIA;RI;1199;10;3;0;13
014013;CASPOGGIO;SO;1342;7;6;0;13
030019;CASSACCO;UD;2807;10;7;0;17
097017;CASSAGO BRIANZA;LC;4370;12;5;0;17
078029;CASSANO ALL'IONIO;CS;16579;13;9;0;22
015059;CASSANO D'ADDA;MI;19194;14;8;0;22
072016;CASSANO DELLE MURGE;BA;14970;12;10;0;22
064021;CASSANO IRPINO;AV;930;7;6;0;13
012040;CASSANO MAGNAGO;VA;21362;15;7;0;22
006191;CASSANO SPINOLA;AL;1825;9;4;0;13
012041;CASSANO VALCUVIA;VA;670;8;5;0;13
089007;CASSARO;SR;725;10;5;0;15
016061;CASSIGLIO;BG;111;5;7;0;12
015060;CASSINA DE' PECCHI;MI;13941;16;6;0;22
013055;CASSINA RIZZARDI;CO;3294;12;5;0;17
097018;CASSINA VALSASSINA;LC;529;9;3;0;12
005021;CASSINASCO;AT;542;11;2;0;13
006043;CASSINE;AL;2821;13;2;0;15
006044;CASSINELLE;AL;852;11;2;0;13
015061;CASSINETTA DI LUGAGNANO;MI;1906;7;4;0;11
060019;CASSINO;FR;35235;23;9;0;32
024026;CASSOLA;VI;15090;12;10;0;22
018035;CASSOLNOVO;PV;6762;11;6;0;17
023020;CASTAGNARO;VR;3587;13;4;0;17
049006;CASTAGNETO CARDUCCI;LI;8785;10;7;0;17
001064;CASTAGNETO PO;TO;1763;10;3;0;13
004046;CASTAGNITO;CN;2184;8;5;0;13
005022;CASTAGNOLE DELLE LANZE;AT;3648;10;7;0;17
005023;CASTAGNOLE MONFERRATO;AT;1152;8;3;0;11
001065;CASTAGNOLE PIEMONTE;TO;2179;7;5;0;12
018036;CASTANA;PV;710;8;5;0;13
015062;CASTANO PRIMO;MI;10862;11;11;0;22
018037;CASTEGGIO;PV;6490;9;8;0;17
017040;CASTEGNATO;BS;8327;11;6;0;17
024027;CASTEGNERO;VI;2849;8;5;0;13
064022;CASTEL BARONIA;AV;1069;10;3;0;13
005024;CASTEL BOGLIONE;AT;572;7;1;0;8
039006;CASTEL BOLOGNESE;RA;9535;8;9;0;17
061023;CASTEL CAMPAGNANO;CE;1473;9;4;0;13
067010;CASTEL CASTAGNA;TE;451;6;4;0;10
022045;CASTEL CONDINO;TN;224;11;4;0;15
037013;CASTEL D'AIANO;BO;1886;8;5;0;13
020014;CASTEL D'ARIO;MN;4594;8;9;0;17
023021;CASTEL D'AZZANO;VR;12053;15;7;0;22
094009;CASTEL DEL GIUDICE;IS;322;12;1;0;13
066026;CASTEL DEL MONTE;AQ;456;9;4;0;13
053004;CASTEL DEL PIANO;GR;4808;9;8;0;17
037014;CASTEL DEL RIO;BO;1186;8;5;0;13
037015;CASTEL DI CASIO;BO;3309;11;5;0;16
066027;CASTEL DI IERI;AQ;296;9;4;0;13
087013;CASTEL DI IUDICA;CT;4309;7;10;0;17
044011;CASTEL DI LAMA;AP;8414;10;7;0;17
083013;CASTEL DI LUCIO;ME;1184;8;7;0;15
066028;CASTEL DI SANGRO;AQ;6543;8;9;0;17
061024;CASTEL DI SASSO;CE;1076;9;4;0;13
057013;CASTEL DI TORA;RI;268;8;5;0;13
051008;CASTEL FOCOGNANO;AR;2963;13;4;0;17
069018;CASTEL FRENTANO;CH;4262;11;6;0;17
019024;CASTEL GABBIANO;CR;458;7;6;0;13
058022;CASTEL GANDOLFO;RM;8652;7;6;0;13
055009;CASTEL GIORGIO;TR;2034;12;1;0;13
020015;CASTEL GOFFREDO;MN;12548;14;8;0;22
037016;CASTEL GUELFO DI BOLOGNA;BO;4516;10;7;0;17
022240;CASTEL IVANO;TN;3260;17;6;0;23
058023;CASTEL MADAMA;RM;7107;9;8;0;17
037019;CASTEL MAGGIORE;BO;18500;13;9;0;22
017042;CASTEL MELLA;BS;10993;12;10;0;22
061026;CASTEL MORRONE;CE;3627;14;3;0;17
054008;CASTEL RITALDI;PG;3048;13;4;0;17
005032;CASTEL ROCCHERO;AT;389;9;4;0;13
016063;CASTEL ROZZONE;BG;2773;9;4;0;13
065034;CASTEL SAN GIORGIO;SA;13655;11;11;0;22
033013;CASTEL SAN GIOVANNI;PC;13981;12;10;0;22
065035;CASTEL SAN LORENZO;SA;2246;11;2;0;13
051010;CASTEL SAN NICCOLO';AR;2517;9;4;0;13
058025;CASTEL SAN PIETRO ROMANO;RM;841;8;5;0;13
037020;CASTEL SAN PIETRO TERME;BO;20666;13;9;0;22
094012;CASTEL SAN VINCENZO;IS;461;12;1;0;13
057015;CASTEL SANT'ANGELO;RI;1195;9;4;0;13
056017;CASTEL SANT'ELIA;VT;2471;7;6;0;13
055010;CASTEL VISCARDO;TR;2731;9;7;0;16
008015;CASTEL VITTORIO;IM;261;8;5;0;13
061027;CASTEL VOLTURNO;CE;27804;15;7;0;22
028029;CASTELBALDO;PD;1430;10;3;0;13
020013;CASTELBELFORTE;MN;3231;12;5;0;17
042008;CASTELBELLINO;AN;4928;9;8;0;17
021018;CASTELBELLO-CIARDES;BZ;2309;15;5;0;20
009020;CASTELBIANCO;SV;316;8;4;0;12
070013;CASTELBOTTACCIO;CB;251;9;4;0;13
082022;CASTELBUONO;PA;8219;8;9;0;17
065030;CASTELCIVITA;SA;1470;8;5;0;13
017041;CASTELCOVATI;BS;6785;10;7;0;17
026011;CASTELCUCCO;TV;2299;8;3;0;11
082023;CASTELDACCIA;PA;11643;13;9;0;22
099021;CASTELDELCI;RN;370;7;5;0;12
004047;CASTELDELFINO;CN;143;9;4;0;13
019023;CASTELDIDONE;CR;569;9;4;0;13
042010;CASTELFIDARDO;AN;18468;13;9;0;22
048010;CASTELFIORENTINO;FI;17364;14;8;0;22
059004;CASTELFORTE;LT;4160;13;4;0;17
064023;CASTELFRANCI;AV;1821;13;0;0;13
050009;CASTELFRANCO DI SOTTO;PI;13460;11;11;0;22
036006;CASTELFRANCO EMILIA;MO;33061;18;13;0;31
062016;CASTELFRANCO IN MISCANO;BN;819;12;1;0;13
051040;CASTELFRANCO PIANDISCO';AR;9832;9;8;0;17
026012;CASTELFRANCO VENETO;TV;33056;23;9;0;32
098062;CASTELGERUNDO;LO;1481;8;5;0;13
024028;CASTELGOMBERTO;VI;6132;9;8;0;17
076021;CASTELGRANDE;PZ;825;9;4;0;13
029011;CASTELGUGLIELMO;RO;1514;8;5;0;13
069019;CASTELGUIDONE;CH;304;8;5;0;13
005025;CASTELL'ALFERO;AT;2637;9;4;0;13
033012;CASTELL'ARQUATO;PC;4577;12;5;0;17
053005;CASTELL'AZZARA;GR;1311;8;5;0;13
083014;CASTELL'UMBERTO;ME;2878;7;8;0;15
065031;CASTELLABATE;SA;8658;10;7;0;17
066029;CASTELLAFIUME;AQ;1044;7;6;0;13
067011;CASTELLALTO;TE;7338;10;7;0;17
081005;CASTELLAMMARE DEL GOLFO;TP;14636;13;9;0;22
063024;CASTELLAMMARE DI STABIA;NA;63330;0;0;3;3
001066;CASTELLAMONTE;TO;9695;11;6;0;17
072017;CASTELLANA GROTTE;BA;19401;13;9;0;22
082024;CASTELLANA SICULA;PA;3089;10;7;0;17
073003;CASTELLANETA;TA;16343;12;10;1;23
006045;CASTELLANIA COPPI;AL;88;11;1;0;12
012042;CASTELLANZA;VA;14077;14;8;0;22
006046;CASTELLAR GUIDOBONO;AL;398;7;6;0;13
035014;CASTELLARANO;RE;15319;16;6;0;22
008014;CASTELLARO;IM;1267;12;1;0;13
006047;CASTELLAZZO BORMIDA;AL;4435;12;5;0;17
003042;CASTELLAZZO NOVARESE;NO;316;9;3;0;12
019025;CASTELLEONE;CR;9270;10;7;0;17
042011;CASTELLEONE DI SUASA;AN;1568;9;4;0;13
005026;CASTELLERO;AT;291;8;5;0;13
096015;CASTELLETTO CERVO;BI;796;7;6;0;13
006048;CASTELLETTO D'ERRO;AL;135;13;0;0;13
006049;CASTELLETTO D'ORBA;AL;1855;9;4;0;13
018038;CASTELLETTO DI BRANDUZZO;PV;989;8;5;0;13
006050;CASTELLETTO MERLI;AL;452;11;2;0;13
005027;CASTELLETTO MOLINA;AT;143;9;4;0;13
006051;CASTELLETTO MONFERRATO;AL;1443;8;5;0;13
003043;CASTELLETTO SOPRA TICINO;NO;9826;13;9;0;22
004049;CASTELLETTO STURA;CN;1349;11;2;0;13
004050;CASTELLETTO UZZONE;CN;310;8;5;0;13
067012;CASTELLI;TE;997;10;3;0;13
016062;CASTELLI CALEPIO;BG;10398;9;7;0;16
052005;CASTELLINA IN CHIANTI;SI;2677;9;4;0;13
050010;CASTELLINA MARITTIMA;PI;1835;6;7;0;13
004051;CASTELLINALDO D'ALBA;CN;915;11;2;0;13
070014;CASTELLINO DEL BIFERNO;CB;444;9;4;0;13
004052;CASTELLINO TANARO;CN;281;8;4;0;12
060020;CASTELLIRI;FR;3202;13;4;0;17
012043;CASTELLO CABIAGLIO;VA;558;8;5;0;13
018039;CASTELLO D'AGOGNA;PV;1072;7;6;0;13
037017;CASTELLO D'ARGILE;BO;6565;8;9;0;17
061025;CASTELLO DEL MATESE;CE;1410;10;3;0;13
014014;CASTELLO DELL'ACQUA;SO;615;8;5;0;13
005028;CASTELLO DI ANNONE;AT;1809;10;3;0;13
097019;CASTELLO DI BRIANZA;LC;2602;8;5;0;13
063025;CASTELLO DI CISTERNA;NA;7815;11;6;0;17
026013;CASTELLO DI GODEGO;TV;7112;11;6;0;17
022048;CASTELLO TESINO;TN;1155;12;5;0;17
022047;CASTELLO-MOLINA DI FIEMME;TN;2319;11;8;0;19
020016;CASTELLUCCHIO;MN;5198;10;7;0;17
071015;CASTELLUCCIO DEI SAURI;FG;2038;11;2;0;13
076022;CASTELLUCCIO INFERIORE;PZ;1947;0;0;1;1
076023;CASTELLUCCIO SUPERIORE;PZ;731;7;6;0;13
071016;CASTELLUCCIO VALMAGGIORE;FG;1226;8;5;0;13
004053;CASTELMAGNO;CN;53;13;0;0;13
013058;CASTELMARTE;CO;1265;9;4;0;13
029012;CASTELMASSA;RO;3997;9;8;0;17
070015;CASTELMAURO;CB;1227;12;1;0;13
076024;CASTELMEZZANO;PZ;727;10;3;0;13
083015;CASTELMOLA;ME;1062;10;5;0;15
018040;CASTELNOVETTO;PV;525;10;3;0;13
029013;CASTELNOVO BARIANO;RO;2639;9;4;0;13
093011;CASTELNOVO DEL FRIULI;PN;831;5;9;0;14
035015;CASTELNOVO DI SOTTO;RE;8385;10;7;0;17
035016;CASTELNOVO NE' MONTI;RE;10309;13;9;0;22
022049;CASTELNUOVO;TN;1078;13;7;0;20
005029;CASTELNUOVO BELBO;AT;805;10;3;0;13
052006;CASTELNUOVO BERARDENGA;SI;8970;12;5;0;17
098013;CASTELNUOVO BOCCA D'ADDA;LO;1542;10;3;0;13
006052;CASTELNUOVO BORMIDA;AL;612;8;3;0;11
013059;CASTELNUOVO BOZZENTE;CO;903;9;4;0;13
005030;CASTELNUOVO CALCEA;AT;692;10;3;0;13
065032;CASTELNUOVO CILENTO;SA;2802;11;2;0;13
023022;CASTELNUOVO DEL GARDA;VR;13370;13;9;0;22
071017;CASTELNUOVO DELLA DAUNIA;FG;1292;11;2;0;13
004054;CASTELNUOVO DI CEVA;CN;102;8;5;0;13
065033;CASTELNUOVO DI CONZA;SA;595;12;1;0;13
057014;CASTELNUOVO DI FARFA;RI;1020;6;6;0;12
046009;CASTELNUOVO DI GARFAGNANA;LU;5650;8;9;0;17
058024;CASTELNUOVO DI PORTO;RM;8587;9;8;0;17
050011;CASTELNUOVO DI VAL DI CECINA;PI;2094;9;4;0;13
005031;CASTELNUOVO DON BOSCO;AT;3109;14;3;0;17
011011;CASTELNUOVO MAGRA;SP;8361;10;7;0;17
001067;CASTELNUOVO NIGRA;TO;401;8;5;0;13
060021;CASTELNUOVO PARANO;FR;858;10;3;0;13
036007;CASTELNUOVO RANGONE;MO;15040;10;12;0;22
006053;CASTELNUOVO SCRIVIA;AL;4874;9;8;0;17
062017;CASTELPAGANO;BN;1350;11;2;0;13
094010;CASTELPETROSO;IS;1565;9;4;0;13
094011;CASTELPIZZUTO;IS;139;10;3;0;13
042012;CASTELPLANIO;AN;3515;12;4;0;16
062018;CASTELPOTO;BN;1114;9;4;0;13
043009;CASTELRAIMONDO;MC;4368;12;5;0;17
021019;CASTELROTTO;BZ;6891;18;6;0;24
043010;CASTELSANTANGELO SUL NERA;MC;232;9;4;0;13
076025;CASTELSARACENO;PZ;1197;9;4;0;13
090023;CASTELSARDO;SS;5711;13;9;0;22
012044;CASTELSEPRIO;VA;1309;5;8;0;13
006054;CASTELSPINA;AL;392;11;1;0;12
084012;CASTELTERMINI;AG;7384;10;7;0;17
012045;CASTELVECCANA;VA;1867;11;2;0;13
066030;CASTELVECCHIO CALVISIO;AQ;124;8;5;0;13
009021;CASTELVECCHIO DI ROCCA BARBENA;SV;133;10;3;0;13
066031;CASTELVECCHIO SUBEQUO;AQ;845;10;3;0;13
062019;CASTELVENERE;BN;2426;12;1;0;13
019026;CASTELVERDE;CR;5549;11;6;0;17
094013;CASTELVERRINO;IS;100;10;3;0;13
062020;CASTELVETERE IN VAL FORTORE;BN;1027;8;5;0;13
064024;CASTELVETERE SUL CALORE;AV;1511;11;2;0;13
081006;CASTELVETRANO;TP;29592;15;10;0;25
036008;CASTELVETRO DI MODENA;MO;11158;11;11;0;22
033014;CASTELVETRO PIACENTINO;PC;5242;8;9;0;17
019027;CASTELVISCONTI;CR;295;9;4;0;13
037021;CASTENASO;BO;15895;16;6;0;22
017043;CASTENEDOLO;BS;11553;11;11;0;22
051011;CASTIGLION FIBOCCHI;AR;2103;8;5;0;13
051012;CASTIGLION FIORENTINO;AR;13052;13;9;0;22
068009;CASTIGLIONE A CASAURIA;PE;734;9;4;0;13
010013;CASTIGLIONE CHIAVARESE;GE;1580;11;2;0;13
078030;CASTIGLIONE COSENTINO;CS;2652;10;3;0;13
098014;CASTIGLIONE D'ADDA;LO;4495;9;8;0;17
052007;CASTIGLIONE D'ORCIA;SI;2148;9;4;0;13
037022;CASTIGLIONE DEI PEPOLI;BO;5363;10;7;0;17
065036;CASTIGLIONE DEL GENOVESI;SA;1310;12;1;0;13
054009;CASTIGLIONE DEL LAGO;PG;15193;13;9;0;22
053006;CASTIGLIONE DELLA PESCAIA;GR;7098;8;9;0;17
020017;CASTIGLIONE DELLE STIVIERE;MN;23313;13;9;0;22
046010;CASTIGLIONE DI GARFAGNANA;LU;1707;10;3;0;13
087014;CASTIGLIONE DI SICILIA;CT;2930;0;0;3;3
004055;CASTIGLIONE FALLETTO;CN;690;10;3;0;13
056018;CASTIGLIONE IN TEVERINA;VT;2281;9;4;0;13
069020;CASTIGLIONE MESSER MARINO;CH;1545;10;3;0;13
067013;CASTIGLIONE MESSER RAIMONDO;TE;2052;12;1;0;13
012046;CASTIGLIONE OLONA;VA;7582;11;6;0;17
004056;CASTIGLIONE TINELLA;CN;811;8;3;0;11
001068;CASTIGLIONE TORINESE;TO;6469;10;7;0;17
044012;CASTIGNANO;AP;2582;9;4;0;13
067014;CASTILENTI;TE;1373;10;3;0;13
004057;CASTINO;CN;458;12;1;0;13
014015;CASTIONE ANDEVENNO;SO;1533;6;6;0;12
016064;CASTIONE DELLA PRESOLANA;BG;3353;13;4;0;17
030020;CASTIONS DI STRADA;UD;3694;14;7;0;21
098015;CASTIRAGA VIDARDO;LO;2952;9;4;0;13
017044;CASTO;BS;1625;10;3;0;13
044013;CASTORANO;AP;2251;10;3;0;13
017045;CASTREZZATO;BS;7494;9;7;0;16
075017;CASTRI DI LECCE;LE;2789;8;5;0;13
075018;CASTRIGNANO DE' GRECI;LE;3727;9;8;0;17
075019;CASTRIGNANO DEL CAPO;LE;5143;8;9;0;17
016065;CASTRO;BG;1232;8;5;0;13
075096;CASTRO;LE;2365;12;1;0;13
060023;CASTRO DEI VOLSCI;FR;4519;11;6;0;17
040005;CASTROCARO TERME E TERRA DEL SOLE;FC;6272;8;9;0;17
060022;CASTROCIELO;FR;3848;14;3;0;17
084013;CASTROFILIPPO;AG;2645;7;8;0;15
078031;CASTROLIBERO;CS;9296;9;8;0;17
012047;CASTRONNO;VA;5039;12;5;0;17
082025;CASTRONOVO DI SICILIA;PA;2865;9;6;0;15
076026;CASTRONUOVO DI SANT'ANDREA;PZ;929;8;5;0;13
070016;CASTROPIGNANO;CB;874;9;4;0;13
083016;CASTROREALE;ME;2244;9;6;0;15
078032;CASTROREGIO;CS;239;10;3;0;13
078033;CASTROVILLARI;CS;20932;14;9;0;23
087015;CATANIA;CT;301104;25;12;0;37
079023;CATANZARO;CZ;85609;30;12;0;42
086006;CATENANUOVA;EN;4546;2;2;1;5
068010;CATIGNANO;PE;1236;10;3;0;13
099002;CATTOLICA;RN;16569;15;7;0;22
084014;CATTOLICA ERACLEA;AG;3325;10;7;0;17
080025;CAULONIA;RC;6739;9;8;0;17
062021;CAUTANO;BN;1950;9;4;0;13
065037;CAVA DE' TIRRENI;SA;51067;24;7;0;31
018041;CAVA MANARA;PV;6649;8;9;0;17
096016;CAVAGLIA';BI;3546;9;8;0;17
003044;CAVAGLIETTO;NO;381;8;5;0;13
003045;CAVAGLIO D'AGOGNA;NO;1165;8;3;0;11
001069;CAVAGNOLO;TO;2226;8;5;0;13
023023;CAVAION VERONESE;VR;6067;11;6;0;17
022050;CAVALESE;TN;4039;14;5;0;19
004058;CAVALLERLEONE;CN;673;10;2;0;12
004059;CAVALLERMAGGIORE;CN;5333;9;8;0;17
075020;CAVALLINO;LE;12839;13;9;0;22
027044;CAVALLINO-TREPORTI;VE;13384;11;11;0;22
003047;CAVALLIRIO;NO;1307;8;5;0;13
022051;CAVARENO;TN;1138;11;7;0;18
013062;CAVARGNA;CO;189;9;3;0;12
012048;CAVARIA CON PREMEZZO;VA;5638;9;8;0;17
027006;CAVARZERE;VE;12962;14;8;0;22
026014;CAVASO DEL TOMBA;TV;2872;12;1;0;13
093012;CAVASSO NUOVO;PN;1501;12;5;0;17
006055;CAVATORE;AL;261;11;2;0;13
030021;CAVAZZO CARNICO;UD;937;8;7;0;15
058026;CAVE;RM;10781;16;6;0;22
022052;CAVEDAGO;TN;563;9;6;0;15
022053;CAVEDINE;TN;3025;11;9;0;20
098017;CAVENAGO D'ADDA;LO;2098;10;3;0;13
016066;CAVERNAGO;BG;2720;8;5;0;13
036009;CAVEZZO;MO;6997;10;7;0;17
022054;CAVIZZANA;TN;247;8;6;0;14
001070;CAVOUR;TO;5374;11;6;0;17
035017;CAVRIAGO;RE;9835;7;10;0;17
020018;CAVRIANA;MN;3747;12;4;0;16
051013;CAVRIGLIA;AR;9462;12;5;0;17
012049;CAZZAGO BRABBIA;VA;802;9;4;0;13
017046;CAZZAGO SAN MARTINO;BS;10749;11;11;0;22
023024;CAZZANO DI TRAMIGNA;VR;1508;10;3;0;13
016067;CAZZANO SANT'ANDREA;BG;1640;10;3;0;13
060024;CECCANO;FR;22501;16;6;0;22
018042;CECIMA;PV;244;10;3;0;13
049007;CECINA;LI;27898;12;10;0;22
017047;CEDEGOLO;BS;1098;6;5;0;11
014016;CEDRASCO;SO;422;8;4;0;12
082026;CEFALA' DIANA;PA;987;9;6;0;15
082027;CEFALU';PA;13958;10;12;0;22
027007;CEGGIA;VE;6146;10;7;0;17
074003;CEGLIE MESSAPICA;BR;18880;14;7;0;21
066032;CELANO;AQ;10379;11;10;0;21
069021;CELENZA SUL TRIGNO;CH;802;11;2;0;13
071018;CELENZA VALFORTORE;FG;1403;10;3;0;13
078034;CELICO;CS;2534;12;1;0;13
019028;CELLA DATI;CR;486;9;4;0;13
006056;CELLA MONTE;AL;467;9;4;0;13
072018;CELLAMARE;BA;5798;10;7;0;17
078035;CELLARA;CS;480;8;5;0;13
005033;CELLARENGO;AT;710;6;7;0;13
017048;CELLATICA;BS;4862;10;7;0;17
065038;CELLE DI BULGHERIA;SA;1773;11;2;0;13
004060;CELLE DI MACRA;CN;84;8;4;0;12
071019;CELLE DI SAN VITO;FG;147;8;5;0;13
005034;CELLE ENOMONDO;AT;452;8;4;0;12
009022;CELLE LIGURE;SV;4910;10;6;0;16
056019;CELLENO;VT;1322;8;4;0;12
056020;CELLERE;VT;1075;11;2;0;13
067015;CELLINO ATTANASIO;TE;2274;10;3;0;13
074004;CELLINO SAN MARCO;BR;6170;11;6;0;17
002171;CELLIO CON BREIA;VC;940;11;2;0;13
061102;CELLOLE;CE;8086;9;8;0;17
022241;CEMBRA LISIGNAGO;TN;2296;13;7;0;20
079024;CENADI;CZ;507;6;7;0;13
016068;CENATE SOPRA;BG;2515;11;2;0;13
016069;CENATE SOTTO;BG;3928;9;8;0;17
025010;CENCENIGHE AGORDINO;BL;1243;8;5;0;13
016070;CENE;BG;4095;9;8;0;17
029014;CENESELLI;RO;1552;8;5;0;13
009023;CENGIO;SV;3293;12;5;0;17
004061;CENTALLO;CN;6875;11;6;0;17
038004;CENTO;FE;35228;20;11;0;31
065039;CENTOLA;SA;5020;9;8;0;17
079025;CENTRACHE;CZ;340;10;3;0;13
013254;CENTRO VALLE INTELVI;CO;3573;10;7;0;17
086007;CENTURIPE;EN;5129;4;1;1;6
068011;CEPAGATTI;PE;10960;14;8;0;22
062022;CEPPALONI;BN;3231;11;6;0;17
060025;CEPRANO;FR;8260;9;8;0;17
086008;CERAMI;EN;1867;9;6;0;15
010014;CERANESI;GE;3637;11;6;0;17
003049;CERANO;NO;6712;8;9;0;17
013063;CERANO D'INTELVI;CO;572;11;2;0;13
018043;CERANOVA;PV;2283;8;5;0;13
065040;CERASO;SA;2268;11;2;0;13
070017;CERCEMAGGIORE;CB;3594;14;3;0;17
001071;CERCENASCO;TO;1782;9;4;0;13
070018;CERCEPICCOLA;CB;610;9;2;0;11
078036;CERCHIARA DI CALABRIA;CS;2184;10;3;0;13
066033;CERCHIO;AQ;1569;10;3;0;13
014017;CERCINO;SO;782;7;4;0;11
030022;CERCIVENTO;UD;652;7;6;0;13
063026;CERCOLA;NA;17124;17;5;0;22
082028;CERDA;PA;4942;9;8;0;17
023025;CEREA;VR;16751;12;10;0;22
029015;CEREGNANO;RO;3440;10;7;0;17
001072;CERES;TO;1017;9;2;0;11
020019;CERESARA;MN;2554;9;4;0;13
006057;CERESETO;AL;396;11;2;0;13
004062;CERESOLE ALBA;CN;2006;8;5;0;13
001073;CERESOLE REALE;TO;159;11;1;0;12
016071;CERETE;BG;1597;7;5;0;12
018044;CERETTO LOMELLINA;PV;178;10;3;0;13
018045;CERGNAGO;PV;681;10;3;0;13
009024;CERIALE;SV;5365;11;6;0;17
008016;CERIANA;IM;1099;7;4;0;11
033015;CERIGNALE;PC;117;7;6;0;13
071020;CERIGNOLA;FG;57127;26;6;0;32
078037;CERISANO;CS;2939;10;7;0;17
013064;CERMENATE;CO;9274;9;8;0;17
021020;CERMES;BZ;1564;9;11;0;20
067016;CERMIGNANO;TE;1459;10;3;0;13
013065;CERNOBBIO;CO;6402;10;7;0;17
097020;CERNUSCO LOMBARDONE;LC;3808;10;7;0;17
015070;CERNUSCO SUL NAVIGLIO;MI;34969;22;10;0;32
005035;CERRETO D'ASTI;AT;222;10;3;0;13
042013;CERRETO D'ESI;AN;3415;9;7;0;16
054010;CERRETO DI SPOLETO;PG;985;7;6;0;13
006058;CERRETO GRUE;AL;302;11;2;0;13
048011;CERRETO GUIDI;FI;10794;13;8;0;21
058027;CERRETO LAZIALE;RM;1104;8;5;0;13
062023;CERRETO SANNITA;BN;3630;13;4;0;17
004063;CERRETTO LANGHE;CN;402;10;3;0;13
006059;CERRINA MONFERRATO;AL;1309;10;3;0;13
096018;CERRIONE;BI;2810;8;5;0;13
015071;CERRO AL LAMBRO;MI;5090;10;7;0;17
094014;CERRO AL VOLTURNO;IS;1155;11;2;0;13
015072;CERRO MAGGIORE;MI;14984;13;9;0;22
005036;CERRO TANARO;AT;588;9;4;0;13
023026;CERRO VERONESE;VR;2581;9;4;0;13
076027;CERSOSIMO;PZ;541;8;5;0;13
048012;CERTALDO;FI;15483;13;9;0;22
018046;CERTOSA DI PAVIA;PV;5455;9;8;0;17
079027;CERVA;CZ;1106;8;5;0;13
058028;CERVARA DI ROMA;RM;441;6;7;0;13
028030;CERVARESE SANTA CROCE;PD;5652;10;6;0;16
060026;CERVARO;FR;7812;10;7;0;17
004064;CERVASCA;CN;5148;11;6;0;17
002041;CERVATTO;VC;50;9;2;0;11
017049;CERVENO;BS;657;9;4;0;13
004065;CERVERE;CN;2255;10;3;0;13
018047;CERVESINA;PV;1133;10;3;0;13
058029;CERVETERI;RM;37741;18;13;0;31
039007;CERVIA;RA;28758;15;7;0;22
078038;CERVICATI;CS;786;10;3;0;13
098018;CERVIGNANO D'ADDA;LO;2184;9;3;0;12
030023;CERVIGNANO DEL FRIULI;UD;13546;17;12;0;29
064025;CERVINARA;AV;8796;8;9;0;17
061028;CERVINO;CE;4805;9;8;0;17
008017;CERVO;IM;1118;9;4;0;13
078039;CERZETO;CS;1228;10;3;0;13
061029;CESA;CE;9444;10;7;0;17
097021;CESANA BRIANZA;LC;2384;8;5;0;13
001074;CESANA TORINESE;TO;913;8;5;0;13
015074;CESANO BOSCONE;MI;23520;11;10;0;21
083017;CESARO';ME;2204;7;8;0;15
015076;CESATE;MI;14218;14;8;0;22
040007;CESENA;FC;96168;22;10;0;32
040008;CESENATICO;FC;25958;13;9;0;22
064026;CESINALI;AV;2565;9;4;0;13
008018;CESIO;IM;273;10;2;0;12
025011;CESIOMAGGIORE;BL;3919;9;8;0;17
026015;CESSALTO;TV;3776;9;8;0;17
043011;CESSAPALOMBO;MC;439;8;5;0;13
005037;CESSOLE;AT;362;9;4;0;13
065041;CETARA;SA;1997;12;1;0;13
017050;CETO;BS;1788;9;4;0;13
052008;CETONA;SI;2516;11;2;0;13
078040;CETRARO;CS;9496;11;11;0;22
004066;CEVA;CN;5641;10;7;0;17
017051;CEVO;BS;820;8;4;0;12
007013;CHALLAND-SAINT-ANSELME;AO;742;10;5;0;15
007014;CHALLAND-SAINT-VICTOR;AO;547;6;8;0;14
007015;CHAMBAVE;AO;886;9;5;0;14
007016;CHAMOIS;AO;109;7;5;0;12
007017;CHAMPDEPRAZ;AO;717;9;6;0;15
007018;CHAMPORCHER;AO;374;11;4;0;15
007019;CHARVENSOD;AO;2367;11;8;0;19
007020;CHATILLON;AO;4402;11;10;0;21
004067;CHERASCO;CN;9447;11;6;0;17
090024;CHEREMULE;SS;402;6;8;0;14
001075;CHIALAMBERTO;TO;344;5;7;0;12
024029;CHIAMPO;VI;12534;13;8;0;21
064027;CHIANCHE;AV;468;12;1;0;13
052009;CHIANCIANO TERME;SI;6848;10;7;0;17
050012;CHIANNI;PI;1315;6;7;0;13
001076;CHIANOCCO;TO;1552;9;3;0;12
088002;CHIARAMONTE GULFI;RG;8024;10;7;0;17
090025;CHIARAMONTI;SS;1525;12;6;0;18
026016;CHIARANO;TV;3665;11;6;0;17
042014;CHIARAVALLE;AN;14306;14;8;0;22
079029;CHIARAVALLE CENTRALE;CZ;5138;8;9;0;17
017052;CHIARI;BS;19131;12;9;0;21
076028;CHIAROMONTE;PZ;1765;12;1;0;13
094015;CHIAUCI;IS;206;9;4;0;13
010015;CHIAVARI;GE;27228;15;7;0;22
014018;CHIAVENNA;SO;7235;10;7;0;17
001077;CHIAVERANO;TO;1985;7;6;0;13
021021;CHIENES;BZ;2986;15;5;0;20
001078;CHIERI;TO;35916;20;12;0;32
025012;CHIES D'ALPAGO;BL;1256;8;5;0;13
014019;CHIESA IN VALMALENCO;SO;2350;9;4;0;13
001079;CHIESANUOVA;TO;231;11;2;0;13
047022;CHIESINA UZZANESE;PT;4468;11;6;0;17
069022;CHIETI;CH;48666;28;14;0;42
071021;CHIEUTI;FG;1563;8;5;0;13
019029;CHIEVE;CR;2235;6;7;0;13
016072;CHIGNOLO D'ISOLA;BG;3364;11;6;0;17
018048;CHIGNOLO PO;PV;3932;13;4;0;17
027008;CHIOGGIA;VE;47903;23;9;0;32
001080;CHIOMONTE;TO;870;9;4;0;13
093013;CHIONS;PN;5100;11;9;0;20
030024;CHIOPRIS-VISCONE;UD;682;7;3;0;10
051014;CHITIGNANO;AR;866;8;5;0;13
016073;CHIUDUNO;BG;6067;11;6;0;17
024030;CHIUPPANO;VI;2496;7;6;0;13
014020;CHIURO;SO;2426;9;4;0;13
004068;CHIUSA DI PESIO;CN;3548;11;6;0;17
001081;CHIUSA DI SAN MICHELE;TO;1556;7;6;0;13
082029;CHIUSA SCLAFANI;PA;2577;8;7;0;15
021022;CHIUSA;BZ;5218;20;4;0;24
030025;CHIUSAFORTE;UD;614;8;2;0;10
008019;CHIUSANICO;IM;593;10;3;0;13
005038;CHIUSANO D'ASTI;AT;250;9;3;0;12
064028;CHIUSANO DI SAN DOMENICO;AV;2110;12;1;0;13
008020;CHIUSAVECCHIA;IM;513;8;5;0;13
052010;CHIUSDINO;SI;1767;7;6;0;13
052011;CHIUSI;SI;8051;7;9;0;16
051015;CHIUSI DELLA VERNA;AR;1889;10;2;0;12
001082;CHIVASSO;TO;26275;14;8;0;22
058118;CIAMPINO;RM;38519;17;15;0;32
084015;CIANCIANA;AG;3159;9;6;0;15
025013;CIBIANA DI CADORE;BL;350;10;3;0;13
010016;CICAGNA;GE;2250;9;4;0;13
079030;CICALA;CZ;893;8;3;0;11
063027;CICCIANO;NA;12311;12;10;0;22
065042;CICERALE;SA;1169;10;2;0;12
058030;CICILIANO;RM;1255;6;5;0;11
019030;CICOGNOLO;CR;915;10;3;0;13
001083;CICONIO;TO;364;10;3;0;13
002042;CIGLIANO;VC;4295;10;7;0;17
004069;CIGLIE';CN;183;9;4;0;13
018049;CIGOGNOLA;PV;1312;10;3;0;13
017053;CIGOLE;BS;1441;12;1;0;13
018050;CILAVEGNA;PV;5308;8;9;0;17
026017;CIMADOLMO;TV;3343;7;9;0;16
017054;CIMBERGO;BS;543;11;2;0;13
080026;CIMINA';RC;530;10;3;0;13
082030;CIMINNA;PA;3466;10;7;0;17
063028;CIMITILE;NA;6940;9;8;0;17
093014;CIMOLAIS;PN;343;8;6;0;14
022058;CIMONE;TN;722;12;4;0;16
005039;CINAGLIO;AT;423;9;4;0;13
058031;CINETO ROMANO;RM;575;9;4;0;13
019031;CINGIA DE' BOTTI;CR;1149;9;3;0;12
043012;CINGOLI;MC;9679;10;12;0;22
053007;CINIGIANO;GR;2390;8;5;0;13
015077;CINISELLO BALSAMO;MI;74391;21;11;0;32
082031;CINISI;PA;11941;8;8;1;17
014021;CINO;SO;333;10;3;0;13
080027;CINQUEFRONDI;RC;6269;8;9;0;17
001084;CINTANO;TO;240;10;3;0;13
022059;CINTE TESINO;TN;338;11;4;0;15
027009;CINTO CAOMAGGIORE;VE;3114;13;4;0;17
028031;CINTO EUGANEO;PD;1928;9;4;0;13
001085;CINZANO;TO;323;8;5;0;13
061030;CIORLANO;CE;372;11;2;0;13
008021;CIPRESSA;IM;1181;10;3;0;13
062024;CIRCELLO;BN;2183;11;2;0;13
001086;CIRIE';TO;18212;15;7;0;22
077005;CIRIGLIANO;MT;290;10;1;0;11
013068;CIRIMIDO;CO;2121;8;5;0;13
022060;CIS;TN;304;12;4;0;16
016074;CISANO BERGAMASCO;BG;6158;9;8;0;17
009025;CISANO SUL NEVA;SV;2122;10;3;0;13
016075;CISERANO;BG;5484;10;7;0;17
012050;CISLAGO;VA;10413;9;8;0;17
015078;CISLIANO;MI;5031;10;6;0;16
026018;CISON DI VALMARINO;TV;2540;9;4;0;13
004070;CISSONE;CN;80;4;9;0;13
005040;CISTERNA D'ASTI;AT;1224;9;4;0;13
059005;CISTERNA DI LATINA;LT;36536;20;12;0;32
074005;CISTERNINO;BR;11231;14;8;0;22
054011;CITERNA;PG;3428;9;8;0;17
054012;CITTA' DELLA PIEVE;PG;7512;10;7;0;17
054013;CITTA' DI CASTELLO;PG;38505;21;11;0;32
068012;CITTA' SANT'ANGELO;PE;14799;14;8;0;22
028032;CITTADELLA;PD;20076;14;8;0;22
057016;CITTADUCALE;RI;6447;9;8;0;17
080028;CITTANOVA;RC;9829;12;8;0;20
057017;CITTAREALE;RI;413;9;4;0;13
012051;CITTIGLIO;VA;3807;12;5;0;17
097022;CIVATE;LC;3713;11;6;0;17
008022;CIVEZZA;IM;628;7;4;0;11
022061;CIVEZZANO;TN;4092;16;7;0;23
002043;CIVIASCO;VC;234;10;3;0;13
030026;CIVIDALE DEL FRIULI;UD;10875;17;10;0;27
016076;CIVIDATE AL PIANO;BG;5036;9;8;0;17
017055;CIVIDATE CAMUNO;BS;2655;8;5;0;13
078041;CIVITA;CS;822;9;4;0;13
056021;CIVITA CASTELLANA;VT;15416;14;8;0;22
066034;CIVITA D'ANTINO;AQ;918;10;3;0;13
070019;CIVITACAMPOMARANO;CB;314;8;5;0;13
069023;CIVITALUPARELLA;CH;292;6;6;0;12
094016;CIVITANOVA DEL SANNIO;IS;890;11;2;0;13
043013;CIVITANOVA MARCHE;MC;41768;21;11;0;32
068013;CIVITAQUANA;PE;1169;11;2;0;13
058032;CIVITAVECCHIA;RM;51880;26;13;0;39
066035;CIVITELLA ALFEDENA;AQ;287;9;4;0;13
068014;CIVITELLA CASANOVA;PE;1605;10;3;0;13
056022;CIVITELLA D'AGLIANO;VT;1493;10;3;0;13
067017;CIVITELLA DEL TRONTO;TE;4601;12;5;0;17
040009;CIVITELLA DI ROMAGNA;FC;3642;10;7;0;17
051016;CIVITELLA IN VAL DI CHIANA;AR;8814;10;7;0;17
069024;CIVITELLA MESSER RAIMONDO;CH;790;11;2;0;13
053008;CIVITELLA PAGANICO;GR;2989;12;5;0;17
066036;CIVITELLA ROVETO;AQ;3069;13;4;0;17
058033;CIVITELLA SAN PAOLO;RM;1989;13;0;0;13
014022;CIVO;SO;1118;9;3;0;12
013071;CLAINO CON OSTENO;CO;539;11;2;0;13
093015;CLAUT;PN;883;8;8;0;16
093016;CLAUZETTO;PN;372;6;7;0;13
004071;CLAVESANA;CN;799;12;1;0;13
001087;CLAVIERE;TO;204;12;1;0;13
022062;CLES;TN;7153;11;13;0;24
078042;CLETO;CS;1194;9;4;0;13
012052;CLIVIO;VA;1938;8;5;0;13
016077;CLUSONE;BG;8510;8;9;0;17
001088;COASSOLO TORINESE;TO;1444;13;0;0;13
001089;COAZZE;TO;3218;10;2;0;12
005041;COAZZOLO;AT;293;11;1;0;12
017056;COCCAGLIO;BS;8728;9;8;0;17
005042;COCCONATO;AT;1406;8;4;0;12
012053;COCQUIO-TREVISAGO;VA;4623;10;7;0;17
066037;COCULLO;AQ;213;11;2;0;13
028033;CODEVIGO;PD;6336;11;6;0;17
018051;CODEVILLA;PV;942;9;4;0;13
038005;CODIGORO;FE;11179;14;8;0;22
026019;CODOGNE';TV;5225;8;9;0;17
098019;CODOGNO;LO;15490;10;9;0;19
030027;CODROIPO;UD;15877;21;11;0;32
090026;CODRONGIANOS;SS;1283;12;5;0;17
096019;COGGIOLA;BI;1651;11;2;0;13
007021;COGNE;AO;1315;11;6;0;17
010017;COGOLETO;GE;8603;9;8;0;17
024032;COGOLLO DEL CENGIO;VI;3156;11;6;0;17
010018;COGORNO;GE;5724;10;7;0;17
003051;COLAZZA;NO;530;9;2;0;11
024126;COLCERESA;VI;5911;9;8;0;17
016078;COLERE;BG;1108;10;2;0;12
060027;COLFELICE;FR;1813;10;3;0;13
033016;COLI;PC;832;7;5;0;12
097023;COLICO;LC;7994;12;5;0;17
057018;COLLALTO SABINO;RI;390;9;4;0;13
066038;COLLARMELE;AQ;814;8;5;0;13
054014;COLLAZZONE;PG;3365;12;5;0;17
097024;COLLE BRIANZA;LC;1773;9;4;0;13
070020;COLLE D'ANCHISE;CB;731;10;3;0;13
057019;COLLE DI TORA;RI;362;10;3;0;13
052012;COLLE DI VAL D'ELSA;SI;21677;12;10;0;22
060029;COLLE SAN MAGNO;FR;636;8;5;0;13
062025;COLLE SANNITA;BN;2209;12;1;0;13
025014;COLLE SANTA LUCIA;BL;353;10;3;0;13
026020;COLLE UMBERTO;TV;5071;11;6;0;17
017057;COLLEBEATO;BS;4479;11;6;0;17
034009;COLLECCHIO;PR;14556;12;10;0;22
068015;COLLECORVINO;PE;5961;9;8;0;17
067018;COLLEDARA;TE;2097;11;2;0;13
069025;COLLEDIMACINE;CH;161;12;1;0;13
069026;COLLEDIMEZZO;CH;439;10;3;0;13
058034;COLLEFERRO;RM;20664;15;7;0;22
057020;COLLEGIOVE;RI;130;11;2;0;13
001090;COLLEGNO;TO;48574;19;13;0;32
066039;COLLELONGO;AQ;1122;6;7;0;13
060028;COLLEPARDO;FR;891;10;3;0;13
075021;COLLEPASSO;LE;5685;9;8;0;17
066040;COLLEPIETRO;AQ;200;11;2;0;13
001091;COLLERETTO CASTELNUOVO;TO;312;7;6;0;13
001092;COLLERETTO GIACOSA;TO;596;6;7;0;13
049008;COLLESALVETTI;LI;16370;14;8;0;22
082032;COLLESANO;PA;3691;10;7;0;17
070021;COLLETORTO;CB;1692;12;1;0;13
057021;COLLEVECCHIO;RI;1548;11;2;0;13
094017;COLLI A VOLTURNO;IS;1271;10;3;0;13
041069;COLLI AL METAURO;PU;12235;14;8;0;22
044014;COLLI DEL TRONTO;AP;3624;10;7;0;17
057022;COLLI SUL VELINO;RI;458;10;3;0;13
018193;COLLI VERDI;PV;1018;11;2;0;13
065043;COLLIANO;SA;3455;12;5;0;17
017058;COLLIO;BS;2041;10;3;0;13
002045;COLLOBIANO;VC;86;7;6;0;13
030028;COLLOREDO DI MONTE ALBANO;UD;2192;10;7;0;17
043014;COLMURANO;MC;1185;7;6;0;13
077006;COLOBRARO;MT;1070;9;4;0;13
023027;COLOGNA VENETA;VR;8423;11;6;0;17
017059;COLOGNE;BS;7562;9;8;0;17
016079;COLOGNO AL SERIO;BG;11065;12;10;0;22
015081;COLOGNO MONZESE;MI;46633;19;13;0;32
023028;COLOGNOLA AI COLLI;VR;8770;8;9;0;17
058035;COLONNA;RM;4231;11;6;0;17
067019;COLONNELLA;TE;3627;11;6;0;17
013074;COLONNO;CO;447;8;5;0;13
014023;COLORINA;SO;1390;7;6;0;13
034010;COLORNO;PR;8958;11;6;0;17
078043;COLOSIMI;CS;1158;9;2;0;11
015082;COLTURANO;MI;2041;5;8;0;13
013251;COLVERDE;CO;5451;10;7;0;17
016080;COLZATE;BG;1620;8;5;0;13
012054;COMABBIO;VA;1221;7;6;0;13
038006;COMACCHIO;FE;21989;17;5;0;22
045005;COMANO;MS;662;7;6;0;13
022228;COMANO TERME;TN;2913;12;8;0;20
098020;COMAZZO;LO;2259;8;5;0;13
030029;COMEGLIANS;UD;442;9;5;0;14
025015;COMELICO SUPERIORE;BL;2089;9;4;0;13
012055;COMERIO;VA;2835;9;4;0;13
017060;COMEZZANO-CIZZAGO;BS;4029;10;6;0;16
003052;COMIGNAGO;NO;1209;7;6;0;13
088003;COMISO;RG;30073;19;13;0;32
084016;COMITINI;AG;896;7;8;0;15
063029;COMIZIANO;NA;1698;0;0;1;1
020020;COMMESSAGGIO;MN;1090;8;5;0;13
022064;COMMEZZADURA;TN;1008;10;4;0;14
013075;COMO;CO;83361;20;22;0;42
034011;COMPIANO;PR;1067;7;6;0;13
016081;COMUN NUOVO;BG;4371;10;7;0;17
044015;COMUNANZA;AP;2943;13;4;0;17
027010;CONA;VE;2788;10;4;0;14
094018;CONCA CASALE;IS;175;11;2;0;13
065044;CONCA DEI MARINI;SA;674;7;3;0;10
061031;CONCA DELLA CAMPANIA;CE;1165;10;3;0;13
023029;CONCAMARISE;VR;1074;7;6;0;13
057023;CONCERVIANO;RI;278;10;3;0;13
017061;CONCESIO;BS;15623;13;9;0;22
027011;CONCORDIA SAGITTARIA;VE;10224;12;10;0;22
036010;CONCORDIA SULLA SECCHIA;MO;8172;9;8;0;17
080029;CONDOFURI;RC;4677;13;4;0;17
001093;CONDOVE;TO;4437;7;10;0;17
083018;CONDRO';ME;464;9;6;0;15
026021;CONEGLIANO;TV;34274;20;12;0;32
018052;CONFIENZA;PV;1545;11;2;0;13
057024;CONFIGNI;RI;586;7;6;0;13
079033;CONFLENTI;CZ;1295;11;2;0;13
006060;CONIOLO;AL;445;9;4;0;13
039008;CONSELICE;RA;9491;10;7;0;17
028034;CONSELVE;PD;10011;10;12;0;22
022242;CONTA';TN;1401;12;7;0;19
082033;CONTESSA ENTELLINA;PA;1529;9;6;0;15
057025;CONTIGLIANO;RI;3689;9;8;0;17
064029;CONTRADA;AV;2961;8;9;0;17
067020;CONTROGUERRA;TE;2236;10;3;0;13
065045;CONTRONE;SA;791;8;5;0;13
065046;CONTURSI TERME;SA;3255;14;3;0;17
072019;CONVERSANO;BA;25784;15;7;0;22
064030;CONZA DELLA CAMPANIA;AV;1286;8;5;0;13
006061;CONZANO;AL;951;7;6;0;13
075022;COPERTINO;LE;23159;15;7;0;22
018053;COPIANO;PV;1708;8;5;0;13
038007;COPPARO;FE;15753;13;9;0;22
018054;CORANA;PV;765;11;2;0;13
072020;CORATO;BA;47117;23;8;0;31
065047;CORBARA;SA;2509;9;4;0;13
015085;CORBETTA;MI;18763;11;11;0;22
029017;CORBOLA;RO;2171;6;7;0;13
056023;CORCHIANO;VT;3594;11;6;0;17
054015;CORCIANO;PG;21429;16;6;0;22
093017;CORDENONS;PN;17886;22;10;0;32
026022;CORDIGNANO;TV;6900;11;6;0;17
093018;CORDOVADO;PN;2726;11;6;0;17
046011;COREGLIA ANTELMINELLI;LU;5096;10;7;0;17
010019;COREGLIA LIGURE;GE;267;5;8;0;13
060030;CORENO AUSONIO;FR;1545;10;3;0;13
066041;CORFINIO;AQ;979;10;3;0;13
059006;CORI;LT;10456;13;9;0;22
099003;CORIANO;RN;10441;14;8;0;22
075023;CORIGLIANO D'OTRANTO;LE;5697;9;8;0;17
078157;CORIGLIANO-ROSSANO;CS;74173;22;9;0;31
042015;CORINALDO;AN;4797;8;9;0;17
001094;CORIO;TO;3048;12;5;0;17
082034;CORLEONE;PA;10493;15;7;0;22
065048;CORLETO MONFORTE;SA;523;10;3;0;13
076029;CORLETO PERTICARA;PZ;2328;8;5;0;13
015086;CORMANO;MI;20327;17;5;0;22
031002;CORMONS;GO;7198;13;9;0;22
016082;CORNA IMAGNA;BG;931;9;4;0;13
016249;CORNALBA;BG;297;10;3;0;13
018191;CORNALE E BASTIDA;PV;820;10;3;0;13
015087;CORNAREDO;MI;20576;0;0;1;1
021023;CORNEDO ALL'ISARCO;BZ;3433;13;10;0;23
024034;CORNEDO VICENTINO;VI;11708;12;10;0;22
098021;CORNEGLIANO LAUDENSE;LO;2834;10;3;0;13
004072;CORNELIANO D'ALBA;CN;2142;9;4;0;13
034012;CORNIGLIO;PR;1740;10;3;0;13
030030;CORNO DI ROSAZZO;UD;3118;16;7;0;23
098022;CORNO GIOVINE;LO;1139;8;5;0;13
098023;CORNOVECCHIO;LO;207;10;3;0;13
026023;CORNUDA;TV;6286;8;9;0;17
035020;CORREGGIO;RE;25008;14;8;0;22
028035;CORREZZOLA;PD;5055;10;7;0;17
013077;CORRIDO;CO;847;7;6;0;13
043015;CORRIDONIA;MC;14821;12;10;0;22
067021;CORROPOLI;TE;5108;13;4;0;17
075024;CORSANO;LE;5199;8;9;0;17
015093;CORSICO;MI;34438;22;9;0;31
005044;CORSIONE;AT;192;7;4;0;11
021024;CORTACCIA SULLA STRADA DEL VINO;BZ;2184;16;4;0;20
079034;CORTALE;CZ;1889;7;6;0;13
005045;CORTANDONE;AT;311;7;3;0;10
005046;CORTANZE;AT;265;10;2;0;12
005047;CORTAZZONE;AT;588;11;2;0;13
033017;CORTE BRUGNATELLA;PC;535;8;5;0;13
019032;CORTE DE' CORTESI CON CIGNONE;CR;1061;8;5;0;13
019033;CORTE DE' FRATI;CR;1311;11;2;0;13
017062;CORTE FRANCA;BS;7147;9;8;0;17
098024;CORTE PALASIO;LO;1529;8;5;0;13
033018;CORTEMAGGIORE;PC;4610;12;5;0;17
004073;CORTEMILIA;CN;2188;10;3;0;13
017063;CORTENO GOLGI;BS;1922;11;2;0;13
097025;CORTENOVA;LC;1147;9;3;0;12
016083;CORTENUOVA;BG;1953;9;4;0;13
018192;CORTEOLONA E GENZONE;PV;2534;9;4;0;13
005048;CORTIGLIONE;AT;536;11;1;0;12
025016;CORTINA D'AMPEZZO;BL;5627;10;7;0;17
021025;CORTINA SULLA STRADA DEL VINO;BZ;661;13;4;0;17
067022;CORTINO;TE;601;11;2;0;13
051017;CORTONA;AR;21324;14;8;0;22
068016;CORVARA;PE;206;10;3;0;13
021026;CORVARA IN BADIA;BZ;1392;17;4;0;21
018057;CORVINO SAN QUIRICO;PV;972;9;4;0;13
017064;CORZANO;BS;1419;7;6;0;13
030031;COSEANO;UD;2045;13;4;0;17
078045;COSENZA;CS;64073;29;13;0;42
008023;COSIO D'ARROSCIA;IM;175;10;3;0;13
014024;COSIO VALTELLINO;SO;5482;10;7;0;17
080030;COSOLETO;RC;795;0;0;3;3
004074;COSSANO BELBO;CN;901;9;4;0;13
001095;COSSANO CANAVESE;TO;440;8;5;0;13
096020;COSSATO;BI;14015;18;4;0;22
009026;COSSERIA;SV;1053;9;4;0;13
044016;COSSIGNANO;AP;861;8;5;0;13
090027;COSSOINE;SS;765;6;8;0;14
005049;COSSOMBRATO;AT;518;7;6;0;13
018058;COSTA DE' NOBILI;PV;380;9;4;0;13
016084;COSTA DI MEZZATE;BG;3317;11;6;0;17
029018;COSTA DI ROVIGO;RO;2448;9;4;0;13
097026;COSTA MASNAGA;LC;4758;11;5;0;16
016247;COSTA SERINA;BG;866;7;4;0;11
016085;COSTA VALLE IMAGNA;BG;547;8;3;0;11
006062;COSTA VESCOVATO;AL;316;8;5;0;13
016086;COSTA VOLPINO;BG;8922;10;7;0;17
024035;COSTABISSARA;VI;7656;11;6;0;17
054016;COSTACCIARO;PG;1110;8;5;0;13
002047;COSTANZANA;VC;761;9;4;0;13
008024;COSTARAINERA;IM;777;11;2;0;13
023030;COSTERMANO SUL GARDA;VR;3933;10;7;0;17
005050;COSTIGLIOLE D'ASTI;AT;5679;10;7;0;17
004075;COSTIGLIOLE SALUZZO;CN;3295;11;6;0;17
039009;COTIGNOLA;RA;7353;10;7;0;17
057026;COTTANELLO;RI;530;9;4;0;13
007022;COURMAYEUR;AO;2615;11;7;0;18
016087;COVO;BG;4218;12;5;0;17
018059;COZZO;PV;355;10;3;0;13
077007;CRACO;MT;644;8;5;0;13
097027;CRANDOLA VALSASSINA;LC;269;12;1;0;13
002048;CRAVAGLIANA;VC;268;8;5;0;13
004076;CRAVANZANA;CN;377;10;1;0;11
024036;CREAZZO;VI;11227;10;10;0;20
069027;CRECCHIO;CH;2628;13;0;0;13
016088;CREDARO;BG;3556;10;6;0;16
019034;CREDERA RUBBIANO;CR;1551;7;6;0;13
019035;CREMA;CR;33970;19;12;0;31
097028;CREMELLA;LC;1679;8;4;0;12
012056;CREMENAGA;VA;775;9;4;0;13
097029;CREMENO;LC;1671;11;2;0;13
013083;CREMIA;CO;691;8;5;0;13
006063;CREMOLINO;AL;1012;8;5;0;13
019036;CREMONA;CR;70841;26;15;0;41
019037;CREMOSANO;CR;1725;10;3;0;13
002049;CRESCENTINO;VC;7636;9;8;0;17
024037;CRESPADORO;VI;1289;8;5;0;13
098025;CRESPIATICA;LO;2192;10;2;0;12
050041;CRESPINA LORENZANA;PI;5426;9;8;0;17
029019;CRESPINO;RO;1733;8;5;0;13
003055;CRESSA;NO;1604;9;4;0;13
096021;CREVACUORE;BI;1390;10;3;0;13
037024;CREVALCORE;BO;13598;14;8;0;22
063030;CRISPANO;NA;11884;12;10;0;22
073004;CRISPIANO;TA;13231;13;9;0;22
004077;CRISSOLO;CN;156;11;2;0;13
010020;CROCEFIESCHI;GE;522;10;3;0;13
026025;CROCETTA DEL MONTELLO;TV;6057;9;8;0;17
067023;CROGNALETO;TE;1119;9;4;0;13
078046;CROPALATI;CS;1017;9;4;0;13
079036;CROPANI;CZ;4657;12;5;0;17
078047;CROSIA;CS;9630;9;7;0;16
012057;CROSIO DELLA VALLE;VA;601;9;4;0;13
019038;CROTTA D'ADDA;CR;620;9;3;0;12
002052;CROVA;VC;372;9;4;0;13
022068;CROVIANA;TN;691;10;5;0;15
012058;CUASSO AL MONTE;VA;3574;7;9;0;16
065049;CUCCARO VETERE;SA;538;11;2;0;13
013084;CUCCIAGO;CO;3442;12;5;0;17
001096;CUCEGLIO;TO;930;7;6;0;13
015096;CUGGIONO;MI;8138;11;6;0;17
012059;CUGLIATE-FABIASCO;VA;3070;13;4;0;17
095019;CUGLIERI;OR;2487;12;4;0;16
068017;CUGNOLI;PE;1350;9;4;0;13
001097;CUMIANA;TO;7821;9;8;0;17
019039;CUMIGNANO SUL NAVIGLIO;CR;408;10;3;0;13
012060;CUNARDO;VA;2885;5;5;0;10
004078;CUNEO;CN;55557;27;15;0;42
005051;CUNICO;AT;437;9;4;0;13
001098;CUORGNE';TO;9411;11;11;0;22
069028;CUPELLO;CH;4748;12;5;0;17
044017;CUPRA MARITTIMA;AP;5402;11;6;0;17
042016;CUPRAMONTANA;AN;4420;9;8;0;17
018060;CURA CARPIGNANO;PV;4915;12;5;0;17
095077;CURCURIS;OR;311;7;7;0;14
003058;CUREGGIO;NO;2576;7;6;0;13
012061;CURIGLIA CON MONTEVIASCO;VA;156;8;5;0;13
079039;CURINGA;CZ;6520;10;7;0;17
096023;CURINO;BI;463;10;4;0;14
016089;CURNO;BG;7453;12;5;0;17
021027;CURON VENOSTA;BZ;2372;12;8;0;20
075025;CURSI;LE;3891;11;4;0;15
028036;CURTAROLO;PD;7138;11;6;0;17
020021;CURTATONE;MN;14711;14;8;0;22
061032;CURTI;CE;6698;10;7;0;17
015097;CUSAGO;MI;4402;8;9;0;17
015098;CUSANO MILANINO;MI;18869;13;9;0;22
062026;CUSANO MUTRI;BN;3822;11;4;0;15
013085;CUSINO;CO;218;11;2;0;13
016090;CUSIO;BG;210;10;3;0;13
081007;CUSTONACI;TP;5306;10;5;0;15
075026;CUTROFIANO;LE;8721;10;7;0;17
012062;CUVEGLIO;VA;3246;12;5;0;17
012063;CUVIO;VA;1631;9;4;0;13
015099;DAIRAGO;MI;6372;9;8;0;17
016091;DALMINE;BG;23241;14;8;0;22
022071;DAMBEL;TN;416;10;4;0;14
025017;DANTA DI CADORE;BL;438;11;2;0;13
017065;DARFO BOARIO TERME;BS;15546;12;10;0;22
010021;DAVAGNA;GE;1857;9;4;0;13
012064;DAVERIO;VA;3085;10;7;0;17
079042;DAVOLI;CZ;5481;10;7;0;17
014025;DAZIO;SO;482;10;3;0;13
092015;DECIMOMANNU;CA;8336;13;10;0;23
079043;DECOLLATURA;CZ;2920;11;6;0;17
009027;DEGO;SV;1856;8;5;0;13
011012;DEIVA MARINA;SP;1292;4;9;0;13
014026;DELEBIO;SO;3331;12;5;0;17
085006;DELIA;CL;3903;8;9;0;17
080031;DELIANUOVA;RC;3125;9;5;0;14
071022;DELICETO;FG;3563;11;6;0;17
017066;DELLO;BS;5578;11;6;0;17
004079;DEMONTE;CN;1853;9;4;0;13
006065;DENICE;AL;171;10;3;0;13
022074;DENNO;TN;1212;12;8;0;20
006066;DERNICE;AL;180;8;5;0;13
019040;DEROVERE;CR;286;8;5;0;13
054017;DERUTA;PG;9444;8;9;0;17
097030;DERVIO;LC;2586;10;3;0;13
002054;DESANA;VC;1063;11;2;0;13
017067;DESENZANO DEL GARDA;BS;29093;16;6;0;22
091016;DESULO;NU;2149;14;3;0;17
078048;DIAMANTE;CS;5084;9;8;0;17
008025;DIANO ARENTINO;IM;685;7;4;0;11
008026;DIANO CASTELLO;IM;2260;9;4;0;13
004080;DIANO D'ALBA;CN;3622;11;6;0;17
008027;DIANO MARINA;IM;5628;9;8;0;17
008028;DIANO SAN PIETRO;IM;1098;9;4;0;13
048013;DICOMANO;FI;5443;10;7;0;17
030032;DIGNANO;UD;2262;11;6;0;17
022233;DIMARO FOLGARIDA;TN;2081;12;7;0;19
078049;DIPIGNANO;CS;4122;12;5;0;17
075027;DISO;LE;2852;13;4;0;17
003060;DIVIGNANO;NO;1433;11;2;0;13
013087;DIZZASCO;CO;636;9;4;0;13
021028;DOBBIACO;BZ;3355;21;3;0;24
031003;DOBERDO' DEL LAGO;GO;1350;11;5;0;16
004081;DOGLIANI;CN;4553;13;4;0;17
069029;DOGLIOLA;CH;311;9;4;0;13
030033;DOGNA;UD;154;7;6;0;13
023031;DOLCE';VR;2502;11;2;0;13
008029;DOLCEACQUA;IM;2145;10;3;0;13
008030;DOLCEDO;IM;1273;9;3;0;12
031004;DOLEGNA DEL COLLIO;GO;317;7;6;0;13
027012;DOLO;VE;14941;9;8;0;17
097031;DOLZAGO;LC;2518;10;3;0;13
078050;DOMANICO;CS;904;11;2;0;13
013089;DOMASO;CO;1451;6;7;0;13
025018;DOMEGGE DI CADORE;BL;2258;7;3;0;10
064031;DOMICELLA;AV;1838;11;2;0;13
096024;DONATO;BI;710;7;6;0;13
013090;DONGO;CO;3233;13;4;0;17
007023;DONNAS;AO;2389;9;9;0;18
091017;DORGALI;NU;8368;10;12;0;22
097032;DORIO;LC;321;12;1;0;13
003062;DORMELLETTO;NO;2561;9;4;0;13
018061;DORNO;PV;4528;13;4;0;17
096025;DORZANO;BI;528;7;4;0;11
020022;DOSOLO;MN;3263;12;5;0;17
016092;DOSSENA;BG;882;11;2;0;13
013092;DOSSO DEL LIRO;CO;236;9;4;0;13
007024;DOUES;AO;502;9;5;0;14
040011;DOVADOLA;FC;1563;9;4;0;13
019041;DOVERA;CR;3762;11;6;0;17
037025;DOZZA;BO;6533;9;8;0;17
061033;DRAGONI;CE;1987;10;3;0;13
022078;DRENA;TN;587;10;5;0;15
030034;DRENCHIA;UD;99;10;4;0;14
015101;DRESANO;MI;3035;9;8;0;17
022079;DRO;TN;5030;18;5;0;23
004082;DRONERO;CN;6902;9;8;0;17
001099;DRUENTO;TO;8973;7;10;0;17
091018;DUALCHI;NU;576;10;3;0;13
014027;DUBINO;SO;3752;10;6;0;16
028106;DUE CARRARE;PD;8963;10;7;0;17
024038;DUEVILLE;VI;13714;12;10;0;22
062027;DUGENTA;BN;2634;13;0;0;13
032001;DUINO AURISINA;TS;8353;14;8;0;22
012065;DUMENZA;VA;1461;9;4;0;13
012066;DUNO;VA;144;11;2;0;13
062028;DURAZZANO;BN;2132;13;0;0;13
070022;DURONIA;CB;397;12;1;0;13
005052;DUSINO SAN MICHELE;AT;1088;9;4;0;13
065050;EBOLI;SA;37594;24;8;0;32
017068;EDOLO;BS;4411;15;2;0;17
021029;EGNA;BZ;5433;16;8;0;24
068018;ELICE;PE;1639;11;2;0;13
091019;ELINI;NU;559;7;7;0;14
097033;ELLO;LC;1207;9;4;0;13
092108;ELMAS;CA;9424;9;13;0;22
004083;ELVA;CN;82;8;5;0;13
007025;EMARÈSE;AO;220;8;6;0;14
048014;EMPOLI;FI;48397;20;12;0;32
016093;ENDINE GAIANO;BG;3379;7;7;0;14
024039;ENEGO;VI;1554;9;4;0;13
030035;ENEMONZO;UD;1280;10;6;0;16
086009;ENNA;EN;25815;22;9;0;31
004084;ENTRACQUE;CN;770;8;5;0;13
016094;ENTRATICO;BG;1992;9;4;0;13
004085;ENVIE;CN;1954;10;2;0;12
076030;EPISCOPIA;PZ;1280;11;2;0;13
027013;ERACLEA;VE;12006;13;9;0;22
013095;ERBA;CO;16091;15;7;0;22
023032;ERBE';VR;1886;8;4;0;12
023033;ERBEZZO;VR;797;10;3;0;13
017069;ERBUSCO;BS;8668;10;7;0;17
074006;ERCHIE;BR;8286;12;5;0;17
063064;ERCOLANO;NA;50580;19;13;0;32
081008;ERICE;TP;26435;16;6;0;22
009028;ERLI;SV;215;10;3;0;13
093019;ERTO E CASSO;PN;373;9;5;0;14
090088;ERULA;SS;691;10;4;0;14
097034;ERVE;LC;686;10;3;0;13
043016;ESANATOGLIA;MC;1916;6;7;0;13
017070;ESINE;BS;5118;9;8;0;17
097035;ESINO LARIO;LC;762;8;5;0;13
060031;ESPERIA;FR;3577;13;4;0;17
090028;ESPORLATU;SS;382;11;3;0;14
028037;ESTE;PD;15975;12;10;0;22
007026;ETROUBLES;AO;472;10;4;0;14
013097;EUPILIO;CO;2575;8;5;0;13
001100;EXILLES;TO;241;8;5;0;13
006067;FABBRICA CURONE;AL;586;12;1;0;13
046036;FABBRICHE DI VERGEMOLI;LU;715;9;4;0;13
035021;FABBRICO;RE;6610;9;8;0;17
042017;FABRIANO;AN;29070;22;10;0;32
056024;FABRICA DI ROMA;VT;8133;11;6;0;17
055011;FABRO;TR;2626;9;4;0;13
030036;FAEDIS;UD;2775;11;11;0;22
014028;FAEDO VALTELLINO;SO;503;10;3;0;13
039010;FAENZA;RA;58899;22;10;0;32
071023;FAETO;FG;606;6;7;0;13
030037;FAGAGNA;UD;6010;11;10;0;21
013098;FAGGETO LARIO;CO;1148;8;5;0;13
073005;FAGGIANO;TA;3423;12;5;0;17
066042;FAGNANO ALTO;AQ;375;10;3;0;13
078051;FAGNANO CASTELLO;CS;3473;11;6;0;17
012067;FAGNANO OLONA;VA;12433;13;9;0;22
022081;FAI DELLA PAGANELLA;TN;905;10;6;0;16
062029;FAICCHIO;BN;3370;10;4;0;14
025019;FALCADE;BL;1824;10;3;0;13
061101;FALCIANO DEL MASSICO;CE;3362;12;5;0;17
078052;FALCONARA ALBANESE;CS;1427;11;2;0;13
042018;FALCONARA MARITTIMA;AN;25576;11;11;0;22
083019;FALCONE;ME;2785;10;5;0;15
056025;FALERIA;VT;1997;12;1;0;13
079047;FALERNA;CZ;3759;13;4;0;17
069104;FALLO;CH;124;9;4;0;13
013099;FALOPPIO;CO;4831;12;5;0;17
060032;FALVATERRA;FR;516;10;3;0;13
021030;FALZES;BZ;2977;16;4;0;20
036011;FANANO;MO;2941;12;5;0;17
093020;FANNA;PN;1480;10;7;0;17
041013;FANO;PU;59926;24;8;0;32
067024;FANO ADRIANO;TE;257;11;2;0;13
069030;FARA FILIORUM PETRI;CH;1971;11;2;0;13
016096;FARA GERA D'ADDA;BG;7977;11;6;0;17
057027;FARA IN SABINA;RI;13848;12;10;0;22
003065;FARA NOVARESE;NO;2007;9;4;0;13
016097;FARA OLIVANA CON SOLA;BG;1312;8;5;0;13
069031;FARA SAN MARTINO;CH;1294;9;4;0;13
024040;FARA VICENTINO;VI;3721;12;5;0;17
076031;FARDELLA;PZ;575;6;7;0;13
004086;FARIGLIANO;CN;1698;10;3;0;13
068019;FARINDOLA;PE;1357;11;2;0;13
033019;FARINI;PC;1078;9;4;0;13
056026;FARNESE;VT;1382;7;6;0;13
031005;FARRA D'ISONZO;GO;1671;9;8;0;17
026026;FARRA DI SOLIGO;TV;8508;8;9;0;17
074007;FASANO;BR;38943;21;11;0;32
010022;FASCIA;GE;73;9;4;0;13
050014;FAUGLIA;PI;3674;12;5;0;17
004087;FAULE;CN;464;9;4;0;13
010023;FAVALE DI MALVARO;GE;433;12;1;0;13
084017;FAVARA;AG;31913;25;7;0;32
081009;FAVIGNANA;TP;4468;9;8;0;17
001101;FAVRIA;TO;5115;10;7;0;17
004088;FEISOGLIO;CN;295;9;2;0;11
001102;FELETTO;TO;2190;10;3;0;13
034013;FELINO;PR;9150;10;7;0;17
065051;FELITTO;SA;1163;10;3;0;13
006068;FELIZZANO;AL;2131;11;2;0;13
025021;FELTRE;BL;20451;17;5;0;22
013100;FENEGRO';CO;3230;10;6;0;16
001103;FENESTRELLE;TO;481;10;3;0;13
055012;FERENTILLO;TR;1822;9;4;0;13
060033;FERENTINO;FR;20162;17;5;0;22
089008;FERLA;SR;2325;9;6;0;15
041014;FERMIGNANO;PU;8239;8;9;0;17
012068;FERNO;VA;6685;10;7;0;17
079048;FEROLETO ANTICO;CZ;1990;11;2;0;13
080032;FEROLETO DELLA CHIESA;RC;1520;12;1;0;13
077008;FERRANDINA;MT;8089;11;6;0;17
038008;FERRARA;FE;129872;27;15;0;42
023034;FERRARA DI MONTE BALDO;VR;259;9;4;0;13
070023;FERRAZZANO;CB;3197;11;6;0;17
012069;FERRERA DI VARESE;VA;700;9;4;0;13
018062;FERRERA ERBOGNONE;PV;1065;10;2;0;12
005053;FERRERE;AT;1499;7;3;0;10
033020;FERRIERE;PC;1116;10;3;0;13
080033;FERRUZZANO;RC;776;9;4;0;13
057028;FIAMIGNANO;RI;1205;8;5;0;13
001104;FIANO;TO;2679;10;2;0;12
058036;FIANO ROMANO;RM;16027;13;9;0;22
043017;FIASTRA;MC;621;11;2;0;13
022083;FIAVE';TN;1068;9;9;0;18
082035;FICARAZZI;PA;12899;13;9;0;22
029021;FICAROLO;RO;2190;5;8;0;13
083020;FICARRA;ME;1316;9;6;0;15
055013;FICULLE;TR;1584;7;6;0;13
034014;FIDENZA;PR;26981;16;6;0;22
021031;FIE' ALLO SCILIAR;BZ;3627;16;7;0;23
022085;FIEROZZO;TN;470;12;4;0;16
019043;FIESCO;CR;1200;8;5;0;13
048015;FIESOLE;FI;13727;13;9;0;22
017071;FIESSE;BS;2003;7;6;0;13
027014;FIESSO D'ARTICO;VE;8422;10;7;0;17
029022;FIESSO UMBERTIANO;RO;3869;8;9;0;17
013101;FIGINO SERENZA;CO;4968;11;6;0;17
048052;FIGLINE E INCISA VALDARNO;FI;23219;15;7;0;22
078053;FIGLINE VEGLIATURO;CS;1113;12;1;0;13
058037;FILACCIANO;RM;472;7;6;0;13
016098;FILAGO;BG;3108;12;4;0;16
045006;FILATTIERA;MS;2210;7;6;0;13
060034;FILETTINO;FR;517;9;4;0;13
069032;FILETTO;CH;878;11;2;0;13
076032;FILIANO;PZ;2768;10;7;0;17
018063;FILIGHERA;PV;815;12;1;0;13
094019;FILIGNANO;IS;586;9;4;0;13
042019;FILOTTRANO;AN;8986;8;9;0;17
036012;FINALE EMILIA;MO;14978;13;9;0;22
009029;FINALE LIGURE;SV;11157;11;11;0;22
016099;FINO DEL MONTE;BG;1155;9;4;0;13
013102;FINO MORNASCO;CO;9829;9;8;0;17
016100;FIORANO AL SERIO;BG;2961;13;4;0;17
001105;FIORANO CANAVESE;TO;735;8;5;0;13
036013;FIORANO MODENESE;MO;16870;18;4;0;22
033021;FIORENZUOLA D'ARDA;PC;14858;13;9;0;22
048017;FIRENZE;FI;361619;30;17;0;47
048018;FIRENZUOLA;FI;4436;13;4;0;17
078054;FIRMO;CS;1880;12;1;0;13
038027;FISCAGLIA;FE;8385;11;6;0;17
065052;FISCIANO;SA;13859;15;7;0;22
060035;FIUGGI;FR;10120;12;10;0;22
036014;FIUMALBO;MO;1180;11;2;0;13
080034;FIUMARA;RC;849;11;2;0;13
093021;FIUME VENETO;PN;11739;19;8;0;27
083021;FIUMEDINISI;ME;1288;9;6;0;15
078055;FIUMEFREDDO BRUZIO;CS;2799;11;6;0;17
087016;FIUMEFREDDO DI SICILIA;CT;9128;10;7;0;17
030190;FIUMICELLO VILLA VICENTINA;UD;6299;14;10;0;24
058120;FIUMICINO;RM;80738;21;11;0;32
043019;FIUMINATA;MC;1275;9;4;0;13
045007;FIVIZZANO;MS;7190;9;8;0;17
030039;FLAIBANO;UD;1095;12;4;0;16
017072;FLERO;BS;8808;10;7;0;17
083022;FLORESTA;ME;470;8;7;0;15
089009;FLORIDIA;SR;21471;15;7;0;22
090029;FLORINAS;SS;1446;8;8;0;16
064032;FLUMERI;AV;2527;13;4;0;17
095080;FLUSSIO;OR;426;8;6;0;14
002057;FOBELLO;VC;186;9;4;0;13
071024;FOGGIA;FG;146803;0;0;3;3
062030;FOGLIANISE;BN;3184;12;5;0;17
031006;FOGLIANO REDIPUGLIA;GO;2992;12;8;0;20
001106;FOGLIZZO;TO;2265;9;4;0;13
051018;FOIANO DELLA CHIANA;AR;9183;10;7;0;17
062031;FOIANO DI VAL FORTORE;BN;1336;8;5;0;13
022087;FOLGARIA;TN;3147;17;6;0;23
044020;FOLIGNANO;AP;8872;12;5;0;17
054018;FOLIGNO;PG;55503;19;13;0;32
026027;FOLLINA;TV;3634;12;5;0;17
011013;FOLLO;SP;6133;11;6;0;17
053009;FOLLONICA;GR;20607;15;7;0;22
098026;FOMBIO;LO;2239;8;5;0;13
083023;FONDACHELLI-FANTINA;ME;943;8;7;0;15
059007;FONDI;LT;39507;23;9;0;32
091024;FONNI;NU;3692;9;8;0;17
007028;FONTAINEMORE;AO;425;7;5;0;12
060036;FONTANA LIRI;FR;2752;11;2;0;13
093022;FONTANAFREDDA;PN;12762;15;12;0;27
064033;FONTANAROSA;AV;2886;13;4;0;17
037026;FONTANELICE;BO;1931;8;5;0;13
016101;FONTANELLA;BG;4722;10;7;0;17
034015;FONTANELLATO;PR;7005;10;7;0;17
026028;FONTANELLE;TV;5657;6;7;0;13
003066;FONTANETO D'AGOGNA;NO;2592;0;0;1;1
002058;FONTANETTO PO;VC;1053;9;4;0;13
010024;FONTANIGORDA;GE;244;7;6;0;13
005054;FONTANILE;AT;493;8;4;0;12
028038;FONTANIVA;PD;7965;8;8;0;16
026029;FONTE;TV;6066;11;6;0;17
058122;FONTE NUOVA;RM;32491;24;8;0;32
066043;FONTECCHIO;AQ;289;6;6;0;12
060037;FONTECHIARI;FR;1256;11;2;0;13
061034;FONTEGRECA;CE;760;13;0;0;13
016102;FONTENO;BG;567;9;4;0;13
034016;FONTEVIVO;PR;5577;10;7;0;17
025022;FONZASO;BL;3053;8;5;0;13
016103;FOPPOLO;BG;168;11;2;0;13
057029;FORANO;RI;3078;9;4;0;13
044021;FORCE;AP;1159;9;4;0;13
062032;FORCHIA;BN;1200;8;5;0;13
014029;FORCOLA;SO;765;11;2;0;13
095020;FORDONGIANUS;OR;850;10;4;0;14
076033;FORENZA;PZ;1875;9;4;0;13
016104;FORESTO SPARSO;BG;3053;14;3;0;17
030137;FORGARIA NEL FRIULI;UD;1708;9;8;0;17
064034;FORINO;AV;5177;12;5;0;17
063031;FORIO;NA;17456;18;3;0;21
040012;FORLI';FC;116558;25;17;0;42
094020;FORLI' DEL SANNIO;IS;633;7;6;0;13
040013;FORLIMPOPOLI;FC;13113;13;9;0;22
058038;FORMELLO;RM;13481;11;6;0;17
059008;FORMIA;LT;37278;20;11;0;31
061035;FORMICOLA;CE;1405;9;4;0;13
019044;FORMIGARA;CR;1001;9;4;0;13
036015;FORMIGINE;MO;34494;18;14;0;32
002059;FORMIGLIANA;VC;497;9;3;0;12
022089;FORNACE;TN;1313;15;5;0;20
094021;FORNELLI;IS;1791;10;3;0;13
030040;FORNI AVOLTRI;UD;515;5;8;0;13
030041;FORNI DI SOPRA;UD;923;10;7;0;17
030042;FORNI DI SOTTO;UD;548;7;7;0;14
001107;FORNO CANAVESE;TO;3230;9;8;0;17
034017;FORNOVO DI TARO;PR;5863;9;8;0;17
016105;FORNOVO SAN GIOVANNI;BG;3386;13;4;0;17
046013;FORTE DEI MARMI;LU;6943;11;6;0;17
021032;FORTEZZA;BZ;1061;10;7;0;17
018064;FORTUNAGO;PV;348;11;2;0;13
083024;FORZA D'AGRO';ME;848;10;5;0;15
046014;FOSCIANDORA;LU;559;7;6;0;13
045008;FOSDINOVO;MS;4597;11;6;0;17
066044;FOSSA;AQ;698;7;6;0;13
069033;FOSSACESIA;CH;6244;8;9;0;17
027015;FOSSALTA DI PIAVE;VE;4147;11;5;0;16
027016;FOSSALTA DI PORTOGRUARO;VE;5792;9;8;0;17
070024;FOSSALTO;CB;1178;10;3;0;13
004089;FOSSANO;CN;24242;12;10;0;22
054019;FOSSATO DI VICO;PG;2652;10;3;0;13
079052;FOSSATO SERRALTA;CZ;574;10;3;0;13
027017;FOSSO';VE;7051;7;10;0;17
041015;FOSSOMBRONE;PU;9096;10;7;0;17
024041;FOZA;VI;661;10;3;0;13
004090;FRABOSA SOPRANA;CN;719;9;4;0;13
004091;FRABOSA SOTTANA;CN;1604;6;6;0;12
006069;FRACONALTO;AL;303;9;4;0;13
073006;FRAGAGNANO;TA;4999;10;7;0;17
062033;FRAGNETO L'ABATE;BN;983;12;1;0;13
062034;FRAGNETO MONFORTE;BN;1689;10;3;0;13
069034;FRAINE;CH;274;10;3;0;13
011014;FRAMURA;SP;599;10;2;0;12
069035;FRANCAVILLA AL MARE;CH;25723;15;7;0;22
006070;FRANCAVILLA BISIO;AL;506;8;5;0;13
083025;FRANCAVILLA DI SICILIA;ME;3591;9;8;0;17
074008;FRANCAVILLA FONTANA;BR;35246;23;9;0;32
076034;FRANCAVILLA IN SINNI;PZ;3985;12;5;0;17
078056;FRANCAVILLA MARITTIMA;CS;2778;11;6;0;17
089010;FRANCOFONTE;SR;11888;12;10;0;22
061036;FRANCOLISE;CE;4623;14;3;0;17
006071;FRASCARO;AL;449;11;2;0;13
018065;FRASCAROLO;PV;1088;8;5;0;13
058039;FRASCATI;RM;22705;14;8;0;22
078057;FRASCINETO;CS;1927;9;4;0;13
022090;FRASSILONGO;TN;338;9;5;0;14
029023;FRASSINELLE POLESINE;RO;1344;8;5;0;13
006072;FRASSINELLO MONFERRATO;AL;470;9;2;0;11
006073;FRASSINETO PO;AL;1362;7;6;0;13
001108;FRASSINETTO;TO;279;11;2;0;13
004092;FRASSINO;CN;262;12;1;0;13
036016;FRASSINORO;MO;1754;11;2;0;13
057030;FRASSO SABINO;RI;736;9;4;0;13
062035;FRASSO TELESINO;BN;2047;10;3;0;13
029024;FRATTA POLESINE;RO;2501;9;4;0;13
054020;FRATTA TODINA;PG;1845;9;4;0;13
063032;FRATTAMAGGIORE;NA;28721;25;7;0;32
063033;FRATTAMINORE;NA;15580;18;4;0;22
041016;FRATTE ROSA;PU;859;10;3;0;13
083026;FRAZZANO';ME;594;9;4;0;13
026030;FREGONA;TV;2815;15;2;0;17
069036;FRESAGRANDINARIA;CH;899;8;5;0;13
006074;FRESONARA;AL;623;8;5;0;13
064035;FRIGENTO;AV;3461;11;6;0;17
061037;FRIGNANO;CE;9010;10;7;0;17
005055;FRINCO;AT;762;10;2;0;12
069037;FRISA;CH;1626;8;4;0;12
093024;FRISANCO;PN;559;8;6;0;14
001109;FRONT;TO;1613;8;4;0;12
041017;FRONTINO;PU;285;9;4;0;13
041018;FRONTONE;PU;1204;8;5;0;13
060038;FROSINONE;FR;43830;29;13;0;42
094022;FROSOLONE;IS;2889;12;5;0;17
001110;FROSSASCO;TO;2799;9;4;0;13
006075;FRUGAROLO;AL;1893;10;3;0;13
006076;FUBINE MONFERRATO;AL;1577;8;5;0;13
048019;FUCECCHIO;FI;22764;12;10;0;22
016106;FUIPIANO VALLE IMAGNA;BG;208;7;6;0;13
023035;FUMANE;VR;4106;11;6;0;17
060039;FUMONE;FR;1997;12;1;0;13
021033;FUNES;BZ;2545;14;6;0;20
069038;FURCI;CH;820;9;4;0;13
083027;FURCI SICULO;ME;3221;10;7;0;17
083028;FURNARI;ME;3851;10;7;0;17
065053;FURORE;SA;700;5;8;0;13
078058;FUSCALDO;CS;7827;10;7;0;17
039011;FUSIGNANO;RA;8075;10;7;0;17
014030;FUSINE;SO;553;10;3;0;13
065054;FUTANI;SA;1100;10;2;0;12
007027;FENIS;AO;1788;9;8;0;17
019045;GABBIONETA BINANUOVA;CR;859;11;2;0;13
006077;GABIANO;AL;1022;12;1;0;13
041019;GABICCE MARE;PU;5540;9;8;0;17
007029;GABY;AO;424;8;5;0;13
019046;GADESCO PIEVE DELMONA;CR;1889;5;7;0;12
091025;GADONI;NU;703;8;6;0;14
059009;GAETA;LT;19598;15;7;0;22
083029;GAGGI;ME;3116;9;8;0;17
015103;GAGGIANO;MI;9218;7;10;0;17
037027;GAGGIO MONTANO;BO;4797;10;7;0;17
096026;GAGLIANICO;BI;3741;8;9;0;17
066045;GAGLIANO ATERNO;AQ;236;8;5;0;13
086010;GAGLIANO CASTELFERRATO;EN;3344;9;8;0;17
075028;GAGLIANO DEL CAPO;LE;4894;8;5;0;13
079055;GAGLIATO;CZ;440;10;3;0;13
043020;GAGLIOLE;MC;523;9;4;0;13
026031;GAIARINE;TV;6025;8;9;0;17
029025;GAIBA;RO;970;10;3;0;13
004093;GAIOLA;CN;574;10;2;0;12
052013;GAIOLE IN CHIANTI;SI;2584;11;2;0;13
091026;GAIRO;NU;1304;12;5;0;17
021034;GAIS;BZ;3230;17;7;0;24
083030;GALATI MAMERTINO;ME;2328;9;6;0;15
075029;GALATINA;LE;25885;15;7;0;22
075030;GALATONE;LE;15095;15;7;0;22
080035;GALATRO;RC;1453;10;3;0;13
097036;GALBIATE;LC;8458;10;7;0;17
040014;GALEATA;FC;2438;8;5;0;13
098027;GALGAGNANO;LO;1310;8;3;0;11
012070;GALLARATE;VA;52452;23;9;0;32
056027;GALLESE;VT;2623;11;2;0;13
003068;GALLIATE;NO;15551;10;12;0;22
012071;GALLIATE LOMBARDO;VA;989;8;3;0;11
018066;GALLIAVOLA;PV;171;8;3;0;11
046015;GALLICANO;LU;3613;9;7;0;16
058040;GALLICANO NEL LAZIO;RM;6500;10;7;0;17
076035;GALLICCHIO;PZ;813;9;4;0;13
037028;GALLIERA;BO;5529;11;6;0;17
028039;GALLIERA VENETA;PD;7105;8;9;0;17
060040;GALLINARO;FR;1220;12;1;0;13
024042;GALLIO;VI;2342;11;2;0;13
075031;GALLIPOLI;LE;19561;16;6;0;22
061038;GALLO MATESE;CE;494;10;3;0;13
083031;GALLODORO;ME;336;9;6;0;15
061039;GALLUCCIO;CE;2041;11;2;0;13
091027;GALTELLI';NU;2384;10;7;0;17
028040;GALZIGNANO TERME;PD;4301;12;4;0;16
006078;GAMALERO;AL;817;10;3;0;13
017073;GAMBARA;BS;4549;9;8;0;17
018067;GAMBARANA;PV;200;10;3;0;13
004094;GAMBASCA;CN;347;9;4;0;13
048020;GAMBASSI TERME;FI;4791;10;7;0;17
070025;GAMBATESA;CB;1283;9;4;0;13
024043;GAMBELLARA;VI;3399;13;4;0;17
069039;GAMBERALE;CH;281;10;3;0;13
040015;GAMBETTOLA;FC;10659;11;10;0;21
018068;GAMBOLO';PV;9697;10;7;0;17
024044;GAMBUGLIANO;VI;829;9;4;0;13
016107;GANDELLINO;BG;965;8;3;0;11
016108;GANDINO;BG;5174;10;7;0;17
016109;GANDOSSO;BG;1445;10;3;0;13
082036;GANGI;PA;6179;11;7;0;18
077009;GARAGUSO;MT;994;9;4;0;13
006079;GARBAGNA;AL;615;8;5;0;13
003069;GARBAGNA NOVARESE;NO;1405;9;4;0;13
015105;GARBAGNATE MILANESE;MI;26792;16;6;0;22
097037;GARBAGNATE MONASTERO;LC;2533;8;5;0;13
023036;GARDA;VR;4142;10;7;0;17
017074;GARDONE RIVIERA;BS;2608;12;1;0;13
017075;GARDONE VAL TROMPIA;BS;11352;13;9;0;22
004095;GARESSIO;CN;2881;9;6;0;15
003070;GARGALLO;NO;1764;12;1;0;13
021035;GARGAZZONE;BZ;1811;16;4;0;20
017076;GARGNANO;BS;2731;13;4;0;17
018069;GARLASCO;PV;9456;10;7;0;17
097038;GARLATE;LC;2666;6;7;0;13
009030;GARLENDA;SV;1348;8;5;0;13
022091;GARNIGA TERME;TN;391;10;4;0;14
013106;GARZENO;CO;676;9;4;0;13
001111;GARZIGLIANA;TO;530;10;3;0;13
079056;GASPERINA;CZ;1908;8;5;0;13
001112;GASSINO TORINESE;TO;9361;11;6;0;17
035022;GATTATICO;RE;5712;12;5;0;17
040016;GATTEO;FC;9320;11;6;0;17
003166;GATTICO-VERUNO;NO;5224;9;8;0;17
002061;GATTINARA;VC;7611;10;7;0;17
017077;GAVARDO;BS;12198;13;9;0;22
029026;GAVELLO;RO;1451;9;4;0;13
016110;GAVERINA TERME;BG;868;10;3;0;13
006081;GAVI;AL;4444;11;6;0;17
058041;GAVIGNANO;RM;1928;12;1;0;13
012072;GAVIRATE;VA;9136;12;5;0;17
091028;GAVOI;NU;2497;11;6;0;17
053010;GAVORRANO;GR;8192;10;7;0;17
020024;GAZOLDO DEGLI IPPOLITI;MN;3007;10;3;0;13
012073;GAZZADA SCHIANNO;VA;4559;11;4;0;15
016111;GAZZANIGA;BG;4928;10;7;0;17
028041;GAZZO;PD;4291;9;8;0;17
023037;GAZZO VERONESE;VR;5178;10;7;0;17
033022;GAZZOLA;PC;2096;9;4;0;13
020025;GAZZUOLO;MN;2087;8;5;0;13
085007;GELA;CL;71937;23;8;0;31
099004;GEMMANO;RN;1121;9;4;0;13
030043;GEMONA DEL FRIULI;UD;10544;17;10;0;27
012074;GEMONIO;VA;2847;9;4;0;13
058042;GENAZZANO;RM;5611;9;8;0;17
042020;GENGA;AN;1664;11;2;0;13
019047;GENIVOLTA;CR;1127;10;3;0;13
004096;GENOLA;CN;2587;10;3;0;13
010025;GENOVA;GE;561203;33;19;0;52
076036;GENZANO DI LUCANIA;PZ;5303;8;9;0;17
058043;GENZANO DI ROMA;RM;23058;15;6;0;21
013107;GERA LARIO;CO;1054;8;5;0;13
080036;GERACE;RC;2399;13;0;0;13
082037;GERACI SICULO;PA;1720;8;6;0;14
058044;GERANO;RM;1157;9;4;0;13
018071;GERENZAGO;PV;1424;11;2;0;13
012075;GERENZANO;VA;10751;17;5;0;22
001113;GERMAGNANO;TO;1120;8;5;0;13
012076;GERMIGNAGA;VA;3743;12;5;0;17
014031;GEROLA ALTA;SO;161;9;4;0;13
019048;GERRE DE' CAPRIOLI;CR;1306;10;3;0;13
015106;GESSATE;MI;8791;12;5;0;17
069040;GESSOPALENA;CH;1234;11;2;0;13
064036;GESUALDO;AV;3274;12;5;0;17
017078;GHEDI;BS;18518;14;8;0;22
003073;GHEMME;NO;3386;13;4;0;17
095021;GHILARZA;OR;4241;12;5;0;17
016113;GHISALBA;BG;6157;9;8;0;17
002062;GHISLARENGO;VC;816;10;3;0;13
029027;GIACCIANO CON BARUCHELLA;RO;2043;8;5;0;13
001114;GIAGLIONE;TO;592;8;5;0;13
017079;GIANICO;BS;2121;8;5;0;13
054021;GIANO DELL'UMBRIA;PG;3654;9;8;0;17
061040;GIANO VETUSTO;CE;655;10;3;0;13
082038;GIARDINELLO;PA;2293;9;6;0;15
083032;GIARDINI NAXOS;ME;9148;11;6;0;17
006082;GIAROLE;AL;671;10;3;0;13
088004;GIARRATANA;RG;2803;6;7;0;13
087017;GIARRE;CT;26685;16;6;0;22
090030;GIAVE;SS;494;9;5;0;14
001115;GIAVENO;TO;16214;11;11;0;22
026032;GIAVERA DEL MONTELLO;TV;5165;10;7;0;17
081010;GIBELLINA;TP;3801;8;8;0;16
096027;GIFFLENGA;BI;104;9;4;0;13
080037;GIFFONE;RC;1615;8;5;0;13
065055;GIFFONI SEI CASALI;SA;4987;10;7;0;17
065056;GIFFONI VALLE PIANA;SA;11602;13;9;0;22
007030;GIGNOD;AO;1699;10;8;0;18
070026;GILDONE;CB;755;13;0;0;13
079058;GIMIGLIANO;CZ;3035;10;5;0;15
076099;GINESTRA;PZ;709;10;3;0;13
062036;GINESTRA DEGLI SCHIAVONI;BN;417;10;1;0;11
073007;GINOSA;TA;21869;10;12;0;22
065057;GIOI;SA;1127;11;2;0;13
066046;GIOIA DEI MARSI;AQ;1705;10;3;0;13
072021;GIOIA DEL COLLE;BA;26731;16;6;0;22
061041;GIOIA SANNITICA;CE;3357;11;6;0;17
080038;GIOIA TAURO;RC;19254;13;8;0;21
080039;GIOIOSA IONICA;RC;6865;9;8;0;17
083033;GIOIOSA MAREA;ME;6737;10;6;0;16
055014;GIOVE;TR;1846;8;5;0;13
072022;GIOVINAZZO;BA;19485;13;9;0;22
022092;GIOVO;TN;2520;15;5;0;20
091031;GIRASOLE;NU;1335;8;9;0;17
079059;GIRIFALCO;CZ;5623;8;9;0;17
069041;GISSI;CH;2517;10;4;0;14
075032;GIUGGIANELLO;LE;1141;8;5;0;13
063034;GIUGLIANO IN CAMPANIA;NA;123758;29;13;0;42
082039;GIULIANA;PA;1731;8;7;0;15
060041;GIULIANO DI ROMA;FR;2348;10;3;0;13
069042;GIULIANO TEATINO;CH;1135;10;3;0;13
067025;GIULIANOVA;TE;23442;16;6;0;22
075033;GIURDIGNANO;LE;1946;7;6;0;13
018072;GIUSSAGO;PV;5245;10;7;0;17
009031;GIUSTENICE;SV;993;8;5;0;13
022093;GIUSTINO;TN;741;12;4;0;16
009032;GIUSVALLA;SV;401;12;1;0;13
001116;GIVOLETTO;TO;4095;10;7;0;17
079060;GIZZERIA;CZ;4997;13;4;0;17
021036;GLORENZA;BZ;924;13;3;0;16
026033;GODEGA DI SANT'URBANO;TV;5942;10;7;0;17
018073;GODIASCO SALICE TERME;PV;3192;12;5;0;17
082040;GODRANO;PA;1063;8;7;0;15
020026;GOITO;MN;10063;11;11;0;22
012077;GOLASECCA;VA;2654;10;3;0;13
018074;GOLFERENZO;PV;175;12;1;0;13
090083;GOLFO ARANCI;SS;2376;13;4;0;17
019049;GOMBITO;CR;617;10;3;0;13
030044;GONARS;UD;4554;11;11;0;22
095022;GONNOSCODINA;OR;436;11;3;0;14
095023;GONNOSNO';OR;712;6;8;0;14
095024;GONNOSTRAMATZA;OR;809;7;7;0;14
020027;GONZAGA;MN;8663;7;9;0;16
014032;GORDONA;SO;1936;7;5;0;12
058045;GORGA;RM;689;9;4;0;13
026034;GORGO AL MONTICANO;TV;4013;8;9;0;17
077010;GORGOGLIONE;MT;870;8;5;0;13
015108;GORGONZOLA;MI;20949;15;7;0;22
066047;GORIANO SICOLI;AQ;510;11;2;0;13
031007;GORIZIA;GO;33615;32;19;0;51
012078;GORLA MAGGIORE;VA;4872;10;7;0;17
012079;GORLA MINORE;VA;8094;9;8;0;17
016114;GORLAGO;BG;5119;10;7;0;17
016115;GORLE;BG;6573;12;5;0;17
012080;GORNATE OLONA;VA;2179;8;5;0;13
016116;GORNO;BG;1498;13;0;0;13
038025;GORO;FE;3533;11;6;0;17
010026;GORRETO;GE;94;9;4;0;13
004097;GORZEGNO;CN;255;9;2;0;11
025025;GOSALDO;BL;539;6;7;0;13
033023;GOSSOLENGO;PC;5711;9;8;0;17
004098;GOTTASECCA;CN;130;10;3;0;13
017080;GOTTOLENGO;BS;4957;10;7;0;17
004099;GOVONE;CN;2255;0;0;1;1
003076;GOZZANO;NO;5487;8;9;0;17
041020;GRADARA;PU;4919;9;8;0;17
031008;GRADISCA D'ISONZO;GO;6370;17;5;0;22
031009;GRADO;GO;7789;13;8;0;21
056028;GRADOLI;VT;1280;9;4;0;13
098028;GRAFFIGNANA;LO;2578;10;3;0;13
056029;GRAFFIGNANO;VT;2120;8;5;0;13
096028;GRAGLIA;BI;1466;9;4;0;13
063035;GRAGNANO;NA;28167;20;2;0;22
033024;GRAGNANO TREBBIENSE;PC;4538;13;4;0;17
087018;GRAMMICHELE;CT;12566;13;8;0;21
005056;GRANA MONFERRATO;AT;523;9;4;0;13
037030;GRANAROLO DELL'EMILIA;BO;12578;13;9;0;22
013110;GRANDATE;CO;2814;12;1;0;13
013111;GRANDOLA ED UNITI;CO;1317;10;3;0;13
083034;GRANITI;ME;1449;10;5;0;15
003077;GRANOZZO CON MONTICELLO;NO;1332;7;6;0;13
012081;GRANTOLA;VA;1237;9;4;0;13
028042;GRANTORTO;PD;4511;12;5;0;17
028043;GRANZE;PD;1948;8;5;0;13
077011;GRASSANO;MT;4788;9;8;0;17
016117;GRASSOBBIO;BG;6436;9;8;0;17
082041;GRATTERI;PA;873;8;7;0;15
013249;GRAVEDONA ED UNITI;CO;4085;11;6;0;17
018075;GRAVELLONA LOMELLINA;PV;2711;10;3;0;13
001117;GRAVERE;TO;666;9;4;0;13
087019;GRAVINA DI CATANIA;CT;25156;15;7;0;22
072023;GRAVINA IN PUGLIA;BA;42915;25;7;0;32
061042;GRAZZANISE;CE;6741;10;7;0;17
005057;GRAZZANO BADOGLIO;AT;577;11;2;0;13
057031;GRECCIO;RI;1514;7;6;0;13
064037;GRECI;AV;591;9;4;0;13
002065;GREGGIO;VC;328;6;7;0;13
006083;GREMIASCO;AL;292;8;5;0;13
007031;GRESSAN;AO;3390;13;8;0;21
007032;GRESSONEY-LA-TRINITE';AO;332;9;6;0;15
007033;GRESSONEY-SAINT-JEAN;AO;799;10;5;0;15
048021;GREVE IN CHIANTI;FI;13327;15;7;0;22
015110;GREZZAGO;MI;3071;10;3;0;13
023038;GREZZANA;VR;10717;13;9;0;22
013113;GRIANTE;CO;591;8;5;0;13
061043;GRICIGNANO DI AVERSA;CE;12628;13;9;0;22
003079;GRIGNASCO;NO;4345;15;2;0;17
022095;GRIGNO;TN;2030;12;7;0;19
030045;GRIMACCO;UD;293;8;3;0;11
078059;GRIMALDI;CS;1536;10;3;0;13
004100;GRINZANE CAVOUR;CN;1987;8;5;0;13
024046;GRISIGNANO DI ZOCCO;VI;4277;13;4;0;17
078060;GRISOLIA;CS;2229;10;3;0;13
037031;GRIZZANA MORANDI;BO;3883;10;6;0;16
006084;GROGNARDO;AL;221;8;5;0;13
016118;GROMO;BG;1134;10;2;0;12
006085;GRONDONA;AL;476;12;1;0;13
016119;GRONE;BG;865;10;3;0;13
019050;GRONTARDO;CR;1489;12;1;0;13
018076;GROPELLO CAIROLI;PV;4242;8;9;0;17
033025;GROPPARELLO;PC;2127;9;4;0;13
001118;GROSCAVALLO;TO;191;8;4;0;12
014033;GROSIO;SO;4371;12;5;0;17
014034;GROSOTTO;SO;1637;10;3;0;13
053011;GROSSETO;GR;81503;28;14;0;42
001119;GROSSO;TO;987;8;5;0;13
058046;GROTTAFERRATA;RM;20455;15;7;0;22
073008;GROTTAGLIE;TA;30869;24;8;0;32
064038;GROTTAMINARDA;AV;7733;9;8;0;17
044023;GROTTAMMARE;AP;15925;13;9;0;22
084018;GROTTE;AG;5298;10;7;0;17
056030;GROTTE DI CASTRO;VT;2442;10;1;0;11
080040;GROTTERIA;RC;2881;14;3;0;17
077012;GROTTOLE;MT;2063;9;4;0;13
064039;GROTTOLELLA;AV;1816;7;6;0;13
027018;GRUARO;VE;2741;11;2;0;13
001120;GRUGLIASCO;TO;37090;20;12;0;32
019051;GRUMELLO CREMONESE ED UNITI;CR;1692;5;8;0;13
016120;GRUMELLO DEL MONTE;BG;7392;9;8;0;17
076037;GRUMENTO NOVA;PZ;1568;9;4;0;13
072024;GRUMO APPULA;BA;12284;13;10;0;23
063036;GRUMO NEVANO;NA;17203;16;6;0;22
024047;GRUMOLO DELLE ABBADESSE;VI;3808;10;7;0;17
075034;GUAGNANO;LE;5486;11;6;0;17
043021;GUALDO;MC;721;6;7;0;13
054022;GUALDO CATTANEO;PG;5691;9;8;0;17
054023;GUALDO TADINO;PG;14313;12;10;0;22
035023;GUALTIERI;RE;6262;8;9;0;17
083035;GUALTIERI SICAMINO';ME;1591;7;8;0;15
013114;GUANZATE;CO;5795;10;7;0;17
060042;GUARCINO;FR;1505;13;0;0;13
029028;GUARDA VENETA;RO;1102;7;6;0;13
002066;GUARDABOSONE;VC;334;6;6;0;12
098029;GUARDAMIGLIO;LO;2634;10;3;0;13
079061;GUARDAVALLE;CZ;4173;12;5;0;17
055015;GUARDEA;TR;1750;8;5;0;13
064040;GUARDIA LOMBARDI;AV;1526;11;2;0;13
076038;GUARDIA PERTICARA;PZ;520;7;6;0;13
078061;GUARDIA PIEMONTESE;CS;1726;11;2;0;13
062037;GUARDIA SANFRAMONDI;BN;4638;10;7;0;17
069043;GUARDIAGRELE;CH;8548;8;9;0;17
070027;GUARDIALFIERA;CB;956;8;5;0;13
070028;GUARDIAREGIA;CB;715;11;2;0;13
050015;GUARDISTALLO;PI;1161;7;6;0;13
004101;GUARENE;CN;3513;11;6;0;17
035024;GUASTALLA;RE;14661;13;9;0;22
006086;GUAZZORA;AL;292;10;3;0;13
054024;GUBBIO;PG;30650;23;9;0;32
015112;GUDO VISCONTI;MI;1634;6;4;0;10
070029;GUGLIONESI;CB;4926;11;6;0;17
020028;GUIDIZZOLO;MN;5971;11;6;0;17
058047;GUIDONIA MONTECELIO;RM;88642;21;11;0;32
036017;GUIGLIA;MO;4049;6;11;0;17
069044;GUILMI;CH;404;11;2;0;13
017081;GUSSAGO;BS;16439;13;9;0;22
019052;GUSSOLA;CR;2610;8;5;0;13
007034;HONE;AO;1148;11;7;0;18
017082;IDRO;BS;1873;9;4;0;13
004102;IGLIANO;CN;67;11;2;0;13
091032;ILBONO;NU;2004;8;9;0;17
023039;ILLASI;VR;5156;10;7;0;17
090031;ILLORAI;SS;763;9;1;0;10
097039;IMBERSAGO;LC;2480;6;7;0;13
022097;IMER;TN;1171;11;7;0;18
037032;IMOLA;BO;69551;16;16;0;32
008031;IMPERIA;IM;41960;28;14;0;42
048022;IMPRUNETA;FI;14477;14;8;0;22
012082;INARZO;VA;1061;11;2;0;13
005058;INCISA SCAPACCINO;AT;2028;8;3;0;11
017083;INCUDINE;BS;345;10;3;0;13
012083;INDUNO OLONA;VA;10278;12;10;0;22
001121;INGRIA;TO;42;12;1;0;13
097040;INTROBIO;LC;1919;9;4;0;13
007035;INTROD;AO;642;7;6;0;13
066048;INTRODACQUA;AQ;1973;10;3;0;13
013118;INVERIGO;CO;9117;11;6;0;17
018077;INVERNO E MONTELEONE;PV;1452;9;4;0;13
001122;INVERSO PINASCA;TO;697;10;3;0;13
015113;INVERUNO;MI;8487;10;7;0;17
003082;INVORIO;NO;4308;10;7;0;17
015114;INZAGO;MI;11245;14;8;0;22
091033;IRGOLI;NU;2232;14;3;0;17
017084;IRMA;BS;136;11;2;0;13
077013;IRSINA;MT;4441;9;8;0;17
004103;ISASCA;CN;72;11;2;0;13
079063;ISCA SULLO IONIO;CZ;1491;10;3;0;13
063037;ISCHIA;NA;19542;15;7;0;22
056031;ISCHIA DI CASTRO;VT;2188;10;3;0;13
071025;ISCHITELLA;FG;4155;13;4;0;17
017085;ISEO;BS;8924;10;7;0;17
022098;ISERA;TN;2776;12;7;0;19
094023;ISERNIA;IS;20748;27;15;0;42
082042;ISNELLO;PA;1334;8;7;0;15
005059;ISOLA D'ASTI;AT;1964;9;4;0;13
010027;ISOLA DEL CANTONE;GE;1392;7;6;0;13
053012;ISOLA DEL GIGLIO;GR;1344;12;1;0;13
067026;ISOLA DEL GRAN SASSO D'ITALIA;TE;4472;13;4;0;17
060043;ISOLA DEL LIRI;FR;10854;14;8;0;22
041021;ISOLA DEL PIANO;PU;556;6;7;0;13
023040;ISOLA DELLA SCALA;VR;11528;12;10;0;22
082043;ISOLA DELLE FEMMINE;PA;7084;10;7;0;17
016121;ISOLA DI FONDRA;BG;171;8;5;0;13
019053;ISOLA DOVARESE;CR;1091;8;5;0;13
023041;ISOLA RIZZA;VR;3230;10;7;0;17
006087;ISOLA SANT'ANTONIO;AL;644;8;4;0;12
024048;ISOLA VICENTINA;VI;10268;8;9;0;17
001123;ISOLABELLA;TO;375;8;5;0;13
008032;ISOLABONA;IM;677;7;6;0;13
071026;ISOLE TREMITI;FG;464;10;2;0;12
017086;ISORELLA;BS;4064;9;8;0;17
065059;ISPANI;SA;988;12;1;0;13
088005;ISPICA;RG;16187;16;6;0;22
012084;ISPRA;VA;5297;8;9;0;17
001124;ISSIGLIO;TO;409;11;2;0;13
007036;ISSIME;AO;378;10;4;0;14
016122;ISSO;BG;622;9;4;0;13
007037;ISSOGNE;AO;1323;14;5;0;19
026035;ISTRANA;TV;9088;9;8;0;17
083036;ITALA;ME;1495;9;6;0;15
059010;ITRI;LT;10371;14;8;0;22
090032;ITTIREDDU;SS;481;8;6;0;14
090033;ITTIRI;SS;8097;13;9;0;22
001125;IVREA;TO;22604;13;9;0;22
019054;IZANO;CR;1949;8;5;0;13
079065;JACURSO;CZ;562;10;3;0;13
070030;JELSI;CB;1638;9;4;0;13
058048;JENNE;RM;336;13;0;0;13
012085;JERAGO CON ORAGO;VA;5273;11;6;0;17
091035;JERZU;NU;3054;1;0;0;1
042021;JESI;AN;39217;22;10;0;32
027019;JESOLO;VE;26556;16;5;0;21
038010;JOLANDA DI SAVOIA;FE;2638;10;7;0;17
084019;JOPPOLO GIANCAXIO;AG;1084;9;6;0;15
007038;JOVENCAN;AO;716;7;7;0;14
066049;L'AQUILA;AQ;69210;25;17;0;42
001126;LA CASSA;TO;1773;7;6;0;13
001127;LA LOGGIA;TO;8779;10;7;0;17
090035;LA MADDALENA;SS;10687;12;10;0;22
007039;LA MAGDELEINE;AO;108;9;4;0;13
004105;LA MORRA;CN;2675;10;3;0;13
007040;LA SALLE;AO;2021;10;7;0;17
011015;LA SPEZIA;SP;92169;28;14;0;42
007041;LA THUILE;AO;816;13;1;0;14
025027;LA VALLE AGORDINA;BL;1060;10;3;0;13
021117;LA VALLE;BZ;1402;15;5;0;20
097092;LA VALLETTA BRIANZA;LC;4670;13;4;0;17
058049;LABICO;RM;6449;9;8;0;17
057032;LABRO;RI;372;9;2;0;11
015115;LACCHIARELLA;MI;9060;10;7;0;17
063038;LACCO AMENO;NA;4642;14;3;0;17
064041;LACEDONIA;AV;2064;9;4;0;13
021037;LACES;BZ;5202;17;7;0;24
095082;LACONI;OR;1685;10;7;0;17
058116;LADISPOLI;RM;40593;20;10;0;30
090034;LAERRU;SS;859;6;6;0;12
080041;LAGANADI;RC;352;11;2;0;13
024049;LAGHI;VI;120;8;5;0;13
013119;LAGLIO;CO;899;7;6;0;13
004104;LAGNASCO;CN;1395;11;2;0;13
078062;LAGO;CS;2303;8;5;0;13
076039;LAGONEGRO;PZ;5138;6;11;0;17
038011;LAGOSANTO;FE;4730;8;9;0;17
021038;LAGUNDO;BZ;5050;18;6;0;24
009033;LAIGUEGLIA;SV;1696;9;3;0;12
015116;LAINATE;MI;26126;12;10;0;22
013120;LAINO;CO;544;8;5;0;13
078063;LAINO BORGO;CS;1737;9;4;0;13
078064;LAINO CASTELLO;CS;789;8;5;0;13
021039;LAION;BZ;2743;16;4;0;20
021040;LAIVES;BZ;18183;26;7;0;33
050016;LAJATICO;PI;1282;10;3;0;13
016123;LALLIO;BG;4119;13;4;0;17
069045;LAMA DEI PELIGNI;CH;1087;11;2;0;13
036018;LAMA MOCOGNO;MO;2667;11;2;0;13
013121;LAMBRUGO;CO;2523;9;4;0;13
079160;LAMEZIA TERME;CZ;67413;21;10;0;31
025026;LAMON;BL;2666;9;8;0;17
084020;LAMPEDUSA E LINOSA;AG;6462;11;6;0;17
047005;LAMPORECCHIO;PT;7398;12;5;0;17
002067;LAMPORO;VC;506;10;3;0;13
021041;LANA;BZ;12415;25;9;0;34
069046;LANCIANO;CH;34201;22;10;0;32
003083;LANDIONA;NO;537;11;2;0;13
018078;LANDRIANO;PV;6446;9;8;0;17
034018;LANGHIRANO;PR;10661;10;7;0;17
018079;LANGOSCO;PV;382;6;7;0;13
091037;LANUSEI;NU;5091;13;9;0;22
058050;LANUVIO;RM;12936;10;12;0;22
014036;LANZADA;SO;1256;9;4;0;13
001128;LANZO TORINESE;TO;4893;10;7;0;17
064042;LAPIO;AV;1446;8;5;0;13
078065;LAPPANO;CS;884;10;3;0;13
047006;LARCIANO;PT;6312;10;7;0;17
018080;LARDIRAGO;PV;1138;9;4;0;13
058115;LARIANO;RM;13200;12;10;0;22
070031;LARINO;CB;6409;10;7;0;17
021042;LASA;BZ;4078;16;8;0;24
082044;LASCARI;PA;3674;8;9;0;17
013123;LASNIGO;CO;456;7;6;0;13
024050;LASTEBASSE;VI;189;8;5;0;13
048024;LASTRA A SIGNA;FI;19674;14;8;0;22
056032;LATERA;VT;777;11;2;0;13
051042;LATERINA PERGINE VALDARNO;AR;6447;9;8;0;17
073009;LATERZA;TA;14906;13;9;0;22
074009;LATIANO;BR;13660;13;9;0;22
059011;LATINA;LT;127861;27;15;0;42
030046;LATISANA;UD;13201;17;10;0;27
076040;LATRONICO;PZ;4129;8;9;0;17
078066;LATTARICO;CS;3774;14;3;0;17
030047;LAUCO;UD;663;7;7;0;14
065060;LAUREANA CILENTO;SA;1225;12;1;0;13
080042;LAUREANA DI BORRELLO;RC;4699;10;7;0;17
021043;LAUREGNO;BZ;325;11;5;0;16
076041;LAURENZANA;PZ;1625;12;1;0;13
076042;LAURIA;PZ;12017;13;9;0;22
001129;LAURIANO;TO;1401;9;4;0;13
065061;LAURINO;SA;1309;8;5;0;13
065062;LAURITO;SA;712;8;5;0;13
064043;LAURO;AV;3330;12;5;0;17
010028;LAVAGNA;GE;12315;13;9;0;22
023042;LAVAGNO;VR;8546;10;7;0;17
022102;LAVARONE;TN;1187;12;6;0;18
076043;LAVELLO;PZ;13028;10;12;0;22
012086;LAVENA-PONTE TRESA;VA;5631;10;7;0;17
012087;LAVENO-MOMBELLO;VA;8324;11;6;0;17
017087;LAVENONE;BS;486;9;4;0;13
065063;LAVIANO;SA;1338;11;2;0;13
022103;LAVIS;TN;9126;16;7;0;23
023043;LAZISE;VR;6849;11;6;0;17
075035;LECCE;LE;94783;33;9;0;42
066050;LECCE NEI MARSI;AQ;1543;6;6;0;12
097042;LECCO;LC;46831;29;13;0;42
022229;LEDRO;TN;5273;22;2;0;24
016124;LEFFE;BG;4308;9;8;0;17
012088;LEGGIUNO;VA;3618;10;7;0;17
023044;LEGNAGO;VR;25313;15;7;0;22
015118;LEGNANO;MI;59955;20;12;0;32
028044;LEGNARO;PD;9353;10;7;0;17
091038;LEI;NU;470;7;4;0;11
001130;LEINI;TO;16321;14;8;0;22
010029;LEIVI;GE;2404;9;4;0;13
001131;LEMIE;TO;185;12;1;0;13
029029;LENDINARA;RO;11457;16;6;0;22
083037;LENI;ME;681;8;5;0;13
016125;LENNA;BG;554;9;3;0;12
017088;LENO;BS;14243;13;9;0;22
059012;LENOLA;LT;4072;12;5;0;17
002068;LENTA;VC;795;9;4;0;13
069047;LENTELLA;CH;649;11;2;0;13
089011;LENTINI;SR;21926;13;7;0;20
057033;LEONESSA;RI;2149;11;2;0;13
086011;LEONFORTE;EN;12513;14;8;0;22
073010;LEPORANO;TA;8187;9;8;0;17
075036;LEQUILE;LE;8688;10;7;0;17
004106;LEQUIO BERRIA;CN;432;8;2;0;10
004107;LEQUIO TANARO;CN;752;9;4;0;13
082045;LERCARA FRIDDI;PA;6329;11;7;0;18
011016;LERICI;SP;9497;13;9;0;22
006088;LERMA;AL;801;11;2;0;13
003084;LESA;NO;2152;9;4;0;13
004108;LESEGNO;CN;788;10;3;0;13
034019;LESIGNANO DE' BAGNI;PR;5054;10;7;0;17
071027;LESINA;FG;6220;12;5;0;17
001132;LESSOLO;TO;1777;0;0;1;1
096085;LESSONA;BI;2634;9;4;0;13
030048;LESTIZZA;UD;3677;13;8;0;21
061044;LETINO;CE;640;10;3;0;13
083038;LETOJANNI;ME;2808;10;4;0;14
063039;LETTERE;NA;6073;10;7;0;17
068020;LETTOMANOPPELLO;PE;2713;11;6;0;17
069048;LETTOPALENA;CH;320;11;2;0;13
011017;LEVANTO;SP;5218;10;7;0;17
016126;LEVATE;BG;3720;10;7;0;17
075037;LEVERANO;LE;13763;14;8;0;22
004109;LEVICE;CN;204;8;4;0;12
022104;LEVICO TERME;TN;8134;20;4;0;24
001133;LEVONE;TO;443;5;8;0;13
013126;LEZZENO;CO;1962;12;1;0;13
061045;LIBERI;CE;1087;11;2;0;13
083039;LIBRIZZI;ME;1584;9;6;0;15
084021;LICATA;AG;34619;23;9;0;32
045009;LICCIANA NARDI;MS;4739;11;6;0;17
058051;LICENZA;RM;891;7;6;0;13
087020;LICODIA EUBEA;CT;2762;8;9;0;17
097043;LIERNA;LC;2167;9;4;0;13
002070;LIGNANA;VC;529;10;2;0;12
030049;LIGNANO SABBIADORO;UD;6833;15;7;0;22
007042;LILLIANES;AO;432;8;6;0;14
025029;LIMANA;BL;5340;8;9;0;17
062038;LIMATOLA;BN;4151;10;7;0;17
028045;LIMENA;PD;8097;10;7;0;17
013128;LIMIDO COMASCO;CO;3864;13;4;0;17
083040;LIMINA;ME;738;9;6;0;15
004110;LIMONE PIEMONTE;CN;1402;10;3;0;13
017089;LIMONE SUL GARDA;BS;1141;11;2;0;13
070032;LIMOSANO;CB;699;10;3;0;13
018081;LINAROLO;PV;2810;8;5;0;13
087021;LINGUAGLOSSA;CT;4995;10;8;0;18
064044;LIONI;AV;6016;10;7;0;17
083041;LIPARI;ME;12508;14;8;0;22
013129;LIPOMO;CO;5985;10;7;0;17
018082;LIRIO;PV;134;10;3;0;13
015122;LISCATE;MI;4009;11;6;0;17
069049;LISCIA;CH;648;10;3;0;13
054025;LISCIANO NICCONE;PG;596;9;4;0;13
004111;LISIO;CN;191;11;2;0;13
063040;LIVERI;NA;1504;12;1;0;13
014037;LIVIGNO;SO;6811;11;6;0;17
025030;LIVINALLONGO DEL COL DI LANA;BL;1263;10;2;0;12
022106;LIVO;TN;781;8;8;0;16
013130;LIVO;CO;165;11;2;0;13
049009;LIVORNO;LI;154483;22;20;0;42
002071;LIVORNO FERRARIS;VC;4180;11;6;0;17
098030;LIVRAGA;LO;2423;11;2;0;13
075038;LIZZANELLO;LE;11840;13;9;0;22
073011;LIZZANO;TA;9628;9;8;0;17
037033;LIZZANO IN BELVEDERE;BO;2172;10;3;0;13
009034;LOANO;SV;10788;14;8;0;22
005060;LOAZZOLO;AT;296;8;5;0;13
001134;LOCANA;TO;1339;12;1;0;13
015125;LOCATE DI TRIULZI;MI;10264;10;7;0;17
013131;LOCATE VARESINO;CO;4303;8;8;0;16
016127;LOCATELLO;BG;823;7;6;0;13
091039;LOCERI;NU;1279;16;1;0;17
072025;LOCOROTONDO;BA;13978;14;8;0;22
080043;LOCRI;RC;11922;15;7;0;22
091040;LOCULI;NU;508;7;4;0;11
091041;LODE';NU;1529;10;7;0;17
098031;LODI;LO;44716;23;18;0;41
098032;LODI VECCHIO;LO;7485;9;8;0;17
091104;LODINE;NU;307;10;4;0;14
017090;LODRINO;BS;1624;5;8;0;13
017091;LOGRATO;BS;3804;11;6;0;17
037034;LOIANO;BO;4369;9;8;0;17
090084;LOIRI PORTO SAN PAOLO;SS;3659;14;4;0;18
097044;LOMAGNA;LC;5026;12;5;0;17
013133;LOMAZZO;CO;9944;10;7;0;17
001135;LOMBARDORE;TO;1670;8;5;0;13
001136;LOMBRIASCO;TO;1090;10;2;0;12
018083;LOMELLO;PV;2022;8;5;0;13
022108;LONA-LASES;TN;873;0;0;1;1
012089;LONATE CEPPINO;VA;5033;10;5;0;15
012090;LONATE POZZOLO;VA;11366;12;10;0;22
017092;LONATO DEL GARDA;BS;16827;14;8;0;22
048025;LONDA;FI;1824;9;4;0;13
094024;LONGANO;IS;637;11;2;0;13
024051;LONGARE;VI;5523;12;5;0;17
025071;LONGARONE;BL;5078;9;8;0;17
017093;LONGHENA;BS;560;7;6;0;13
083042;LONGI;ME;1350;10;5;0;15
040018;LONGIANO;FC;7225;9;8;0;17
078067;LONGOBARDI;CS;2326;11;2;0;13
078068;LONGOBUCCO;CS;2700;12;5;0;17
013134;LONGONE AL SEGRINO;CO;1947;8;4;0;12
057034;LONGONE SABINO;RI;541;9;4;0;13
024052;LONIGO;VI;15746;14;8;0;22
001137;LORANZE';TO;1149;11;2;0;13
028046;LOREGGIA;PD;7659;8;9;0;17
025032;LORENZAGO DI CADORE;BL;575;8;5;0;13
029030;LOREO;RO;3275;11;6;0;17
042022;LORETO;AN;12843;11;11;0;22
068021;LORETO APRUTINO;PE;7156;11;6;0;17
026036;LORIA;TV;9313;10;7;0;17
051020;LORO CIUFFENNA;AR;5854;11;6;0;17
043022;LORO PICENO;MC;2181;8;5;0;13
010030;LORSICA;GE;412;9;4;0;13
017094;LOSINE;BS;625;10;3;0;13
091042;LOTZORAI;NU;2116;12;5;0;17
016128;LOVERE;BG;5001;10;7;0;17
014038;LOVERO;SO;627;9;4;0;13
017095;LOZIO;BS;353;8;5;0;13
012091;LOZZA;VA;1203;8;4;0;12
028047;LOZZO ATESTINO;PD;2981;14;3;0;17
025033;LOZZO DI CADORE;BL;1272;5;7;0;12
002072;LOZZOLO;VC;797;9;4;0;13
006193;LU E CUCCARO MONFERRATO;AL;1330;8;5;0;13
056033;LUBRIANO;VT;888;7;6;0;13
046017;LUCCA;LU;89078;29;13;0;42
084022;LUCCA SICULA;AG;1733;9;6;0;15
071028;LUCERA;FG;31458;23;9;0;32
051021;LUCIGNANO;AR;3396;13;3;0;16
008033;LUCINASCO;IM;293;8;5;0;13
070033;LUCITO;CB;630;4;9;0;13
066051;LUCO DEI MARSI;AQ;5996;11;6;0;17
066052;LUCOLI;AQ;872;9;4;0;13
033026;LUGAGNANO VAL D'ARDA;PC;3880;6;11;0;17
055016;LUGNANO IN TEVERINA;TR;1431;9;3;0;12
039012;LUGO;RA;31919;19;13;0;32
024053;LUGO DI VICENZA;VI;3562;13;4;0;17
012092;LUINO;VA;14128;14;8;0;22
013135;LUISAGO;CO;2730;8;5;0;13
091043;LULA;NU;1266;10;6;0;16
010031;LUMARZO;GE;1433;10;3;0;13
017096;LUMEZZANE;BS;21410;14;8;0;22
041022;LUNANO;PU;1434;9;4;0;13
018084;LUNGAVILLA;PV;2457;6;7;0;13
078069;LUNGRO;CS;2227;9;4;0;13
011020;LUNI;SP;8208;9;8;0;17
064045;LUOGOSANO;AV;1097;12;1;0;13
090036;LUOGOSANTO;SS;1818;12;4;0;16
070034;LUPARA;CB;415;10;3;0;13
013136;LURAGO D'ERBA;CO;5405;9;8;0;17
013137;LURAGO MARINONE;CO;2553;11;2;0;13
016129;LURANO;BG;2811;9;4;0;13
090037;LURAS;SS;2429;9;8;0;17
013138;LURATE CACCIVIO;CO;9708;9;8;0;17
061046;LUSCIANO;CE;15842;15;7;0;22
022109;LUSERNA;TN;270;9;6;0;15
001139;LUSERNA SAN GIOVANNI;TO;7162;10;7;0;17
001140;LUSERNETTA;TO;480;11;2;0;13
030051;LUSEVERA;UD;585;9;4;0;13
029031;LUSIA;RO;3323;10;5;0;15
024127;LUSIANA CONCO;VI;4553;10;7;0;17
001141;LUSIGLIE';TO;541;8;5;0;13
021044;LUSON;BZ;1546;13;7;0;20
065064;LUSTRA;SA;994;9;4;0;13
012093;LUVINATE;VA;1310;8;5;0;13
016130;LUZZANA;BG;881;8;4;0;12
035026;LUZZARA;RE;8402;10;7;0;17
078070;LUZZI;CS;8796;11;6;0;17
012142;MACCAGNO CON PINO E VEDDASCA;VA;2403;11;2;0;13
098033;MACCASTORNA;LO;63;12;1;0;13
094025;MACCHIA D'ISERNIA;IS;1030;10;3;0;13
070035;MACCHIA VALFORTORE;CB;490;11;1;0;12
094026;MACCHIAGODENA;IS;1655;5;8;0;13
001142;MACELLO;TO;1155;10;3;0;13
043023;MACERATA;MC;40503;27;15;0;42
061047;MACERATA CAMPANIA;CE;10048;0;0;1;1
041023;MACERATA FELTRIA;PU;1915;11;2;0;13
017097;MACLODIO;BS;1483;8;4;0;12
091044;MACOMER;NU;9444;12;9;0;21
004112;MACRA;CN;43;10;3;0;13
061048;MADDALONI;CE;37146;27;5;0;32
014035;MADESIMO;SO;530;5;8;0;13
019055;MADIGNANO;CR;2760;8;4;0;12
016131;MADONE;BG;4025;11;6;0;17
022243;MADRUZZO;TN;2963;12;8;0;20
059013;MAENZA;LT;2977;10;7;0;17
070036;MAFALDA;CB;1092;9;4;0;13
017098;MAGASA;BS;107;11;2;0;13
015130;MAGENTA;MI;24130;16;6;0;22
003088;MAGGIORA;NO;1609;7;5;0;12
018085;MAGHERNO;PV;1754;9;4;0;13
054026;MAGIONE;PG;14602;12;10;0;22
079068;MAGISANO;CZ;1111;10;3;0;13
004113;MAGLIANO ALFIERI;CN;2173;11;2;0;13
004114;MAGLIANO ALPI;CN;2130;10;3;0;13
066053;MAGLIANO DE' MARSI;AQ;3525;17;0;0;17
053013;MAGLIANO IN TOSCANA;GR;3316;9;8;0;17
058052;MAGLIANO ROMANO;RM;1415;7;6;0;13
057035;MAGLIANO SABINA;RI;3483;13;3;0;16
065065;MAGLIANO VETERE;SA;606;10;3;0;13
075039;MAGLIE;LE;13619;12;10;0;22
009035;MAGLIOLO;SV;933;11;2;0;13
001143;MAGLIONE;TO;419;3;9;0;12
020029;MAGNACAVALLO;MN;1428;7;6;0;13
015131;MAGNAGO;MI;9336;10;7;0;17
096030;MAGNANO;BI;366;10;3;0;13
030052;MAGNANO IN RIVIERA;UD;2273;10;5;0;15
095083;MAGOMADAS;OR;604;8;6;0;14
021045;MAGRE' SULLA STRADA DEL VINO;BZ;1292;16;4;0;20
013139;MAGREGLIO;CO;687;10;3;0;13
079069;MAIDA;CZ;4428;10;7;0;17
078071;MAIERA';CS;1139;10;3;0;13
042023;MAIOLATI SPONTINI;AN;6097;10;7;0;17
099022;MAIOLO;RN;785;8;5;0;13
065066;MAIORI;SA;5397;9;8;0;17
098034;MAIRAGO;LO;1385;12;1;0;13
017099;MAIRANO;BS;3492;10;7;0;17
011018;MAISSANA;SP;583;9;4;0;13
030053;MAJANO;UD;5834;10;11;0;21
019056;MALAGNINO;CR;1719;10;3;0;13
037035;MALALBERGO;BO;9045;12;5;0;17
030054;MALBORGHETTO VALBRUNA;UD;910;8;5;0;13
023045;MALCESINE;VR;3596;11;6;0;17
022110;MALE';TN;2265;14;6;0;20
017100;MALEGNO;BS;1960;7;4;0;11
098035;MALEO;LO;3017;11;6;0;17
087022;MALETTO;CT;3598;11;6;0;17
083043;MALFA;ME;978;9;5;0;14
097045;MALGRATE;LC;4296;12;4;0;16
078072;MALITO;CS;747;7;6;0;13
009036;MALLARE;SV;1061;9;4;0;13
021046;MALLES VENOSTA;BZ;5233;19;5;0;24
012096;MALNATE;VA;16347;11;11;0;22
024055;MALO;VI;14682;14;8;0;22
017101;MALONNO;BS;3030;10;7;0;17
044027;MALTIGNANO;AP;2259;6;6;0;12
083044;MALVAGNA;ME;639;8;5;0;13
006090;MALVICINO;AL;79;9;4;0;13
078073;MALVITO;CS;1661;11;2;0;13
080044;MAMMOLA;RC;2498;6;7;0;13
091046;MAMOIADA;NU;2426;9;8;0;17
053014;MANCIANO;GR;7113;12;5;0;17
083045;MANDANICI;ME;531;8;7;0;15
078074;MANDATORICCIO;CS;2455;9;4;0;13
058053;MANDELA;RM;906;13;0;0;13
097046;MANDELLO DEL LARIO;LC;10014;13;9;0;22
003090;MANDELLO VITTA;NO;228;10;3;0;13
073012;MANDURIA;TA;30117;24;7;0;31
017102;MANERBA DEL GARDA;BS;5415;13;4;0;17
017103;MANERBIO;BS;13163;12;10;0;22
071029;MANFREDONIA;FG;54342;19;12;0;31
004115;MANGO;CN;1253;9;4;0;13
078075;MANGONE;CS;1885;13;0;0;13
087057;MANIACE;CT;3768;11;5;0;16
093025;MANIAGO;PN;11555;15;12;0;27
064046;MANOCALZATI;AV;3051;14;3;0;17
068022;MANOPPELLO;PE;6771;10;7;0;17
026037;MANSUE';TV;4967;10;7;0;17
004116;MANTA;CN;3765;9;8;0;17
014039;MANTELLO;SO;753;8;4;0;12
020030;MANTOVA;MN;48441;25;17;0;42
030055;MANZANO;UD;6238;14;8;0;22
058054;MANZIANA;RM;7735;9;8;0;17
016132;MAPELLO;BG;6878;6;11;0;17
001316;MAPPANO;TO;7369;9;8;0;17
090038;MARA;SS;526;12;2;0;14
092037;MARACALAGONIS;CA;7909;13;9;0;22
036019;MARANELLO;MO;17270;13;9;0;22
063041;MARANO DI NAPOLI;NA;58042;21;9;0;30
023046;MARANO DI VALPOLICELLA;VR;3115;11;6;0;17
058055;MARANO EQUO;RM;784;11;2;0;13
030056;MARANO LAGUNARE;UD;1756;11;6;0;17
078076;MARANO MARCHESATO;CS;3333;11;6;0;17
078077;MARANO PRINCIPATO;CS;3063;12;5;0;17
036020;MARANO SUL PANARO;MO;5323;12;5;0;17
003091;MARANO TICINO;NO;1568;8;4;0;12
024056;MARANO VICENTINO;VI;9351;10;7;0;17
005061;MARANZANA;AT;230;7;6;0;13
076044;MARATEA;PZ;4817;8;10;0;18
015134;MARCALLO CON CASONE;MI;6186;10;7;0;17
020031;MARCARIA;MN;6363;7;6;0;13
079071;MARCEDUSA;CZ;395;11;2;0;13
058056;MARCELLINA;RM;7090;11;6;0;17
079072;MARCELLINARA;CZ;2182;10;3;0;13
057036;MARCETELLI;RI;69;10;3;0;13
017104;MARCHENO;BS;4196;8;9;0;17
012097;MARCHIROLO;VA;3512;10;7;0;17
049010;MARCIANA;LI;2030;10;3;0;13
049011;MARCIANA MARINA;LI;1876;8;5;0;13
061049;MARCIANISE;CE;38523;22;10;0;32
051022;MARCIANO DELLA CHIANA;AR;3458;12;5;0;17
018086;MARCIGNAGO;PV;2426;8;5;0;13
027020;MARCON;VE;17558;14;7;0;21
021047;MAREBBE;BZ;3159;17;3;0;20
004117;MARENE;CN;3269;10;6;0;16
026038;MARENO DI PIAVE;TV;9548;10;7;0;17
001144;MARENTINO;TO;1300;8;5;0;13
005062;MARETTO;AT;380;11;2;0;13
004118;MARGARITA;CN;1429;9;4;0;13
097047;MARGNO;LC;375;10;3;0;13
020032;MARIANA MANTOVANA;MN;804;8;5;0;13
013143;MARIANO COMENSE;CO;25182;17;5;0;22
031010;MARIANO DEL FRIULI;GO;1464;8;7;0;15
085008;MARIANOPOLI;CL;1642;11;4;0;15
063042;MARIGLIANELLA;NA;7832;10;7;0;17
063043;MARIGLIANO;NA;29166;22;9;0;31
080045;MARINA DI GIOIOSA IONICA;RC;6304;10;7;0;17
082046;MARINEO;PA;6214;10;8;0;18
058057;MARINO;RM;46048;22;10;0;32
021048;MARLENGO;BZ;2838;15;5;0;20
047007;MARLIANA;PT;3149;11;6;0;17
017105;MARMENTINO;BS;665;8;5;0;13
020033;MARMIROLO;MN;7625;10;7;0;17
004119;MARMORA;CN;54;9;4;0;13
012098;MARNATE;VA;8032;10;7;0;17
017106;MARONE;BS;3114;12;5;0;17
080046;MAROPATI;RC;1385;11;2;0;13
024057;MAROSTICA;VI;13966;12;10;0;22
048026;MARRADI;FI;2891;7;6;0;13
095025;MARRUBIU;OR;4643;11;6;0;17
004120;MARSAGLIA;CN;214;7;6;0;13
081011;MARSALA;TP;80474;25;5;0;30
054027;MARSCIANO;PG;18038;14;8;0;22
076045;MARSICO NUOVO;PZ;3870;10;7;0;17
076046;MARSICOVETERE;PZ;5556;10;7;0;17
056034;MARTA;VT;3271;12;5;0;17
075040;MARTANO;LE;8620;9;8;0;17
027021;MARTELLAGO;VE;21279;14;8;0;22
021049;MARTELLO;BZ;828;14;3;0;17
030057;MARTIGNACCO;UD;6847;18;5;0;23
019057;MARTIGNANA DI PO;CR;2045;7;6;0;13
075041;MARTIGNANO;LE;1586;9;4;0;13
073013;MARTINA FRANCA;TA;47301;20;12;0;32
016133;MARTINENGO;BG;10733;15;7;0;22
004121;MARTINIANA PO;CN;752;10;3;0;13
067047;MARTINSICURO;TE;16219;14;8;0;22
079073;MARTIRANO;CZ;854;12;1;0;13
079074;MARTIRANO LOMBARDO;CZ;980;9;4;0;13
090039;MARTIS;SS;470;11;3;0;14
080047;MARTONE;RC;503;12;1;0;13
098036;MARUDO;LO;1769;9;4;0;13
073014;MARUGGIO;TA;5288;9;8;0;17
037036;MARZABOTTO;BO;6806;9;8;0;17
018087;MARZANO;PV;1684;10;3;0;13
061050;MARZANO APPIO;CE;2013;12;1;0;13
064047;MARZANO DI NOLA;AV;1624;9;3;0;12
078078;MARZI;CS;964;10;3;0;13
012099;MARZIO;VA;310;5;8;0;13
015136;MASATE;MI;3671;13;4;0;17
087023;MASCALI;CT;14287;11;11;0;22
087024;MASCALUCIA;CT;31998;23;8;0;31
076047;MASCHITO;PZ;1506;10;3;0;13
012100;MASCIAGO PRIMO;VA;303;9;4;0;13
026039;MASER;TV;5125;12;5;0;17
028048;MASERA' DI PADOVA;PD;9092;11;6;0;17
026040;MASERADA SUL PIAVE;TV;9225;10;7;0;17
028049;MASI;PD;1780;6;5;0;11
038012;MASI TORELLO;FE;2291;8;5;0;13
006091;MASIO;AL;1278;10;3;0;13
013144;MASLIANICO;CO;3131;10;7;0;17
010032;MASONE;GE;3443;9;8;0;17
045010;MASSA;MS;66498;29;13;0;42
066054;MASSA D'ALBE;AQ;1365;12;1;0;13
063092;MASSA DI SOMMA;NA;5056;11;6;0;17
047008;MASSA E COZZILE;PT;7698;10;7;0;17
039013;MASSA LOMBARDA;RA;10590;9;13;0;22
063044;MASSA LUBRENSE;NA;14146;14;8;0;22
053015;MASSA MARITTIMA;GR;8124;10;7;0;17
054028;MASSA MARTANA;PG;3641;11;6;0;17
073015;MASSAFRA;TA;32116;21;11;0;32
098037;MASSALENGO;LO;4379;11;6;0;17
028050;MASSANZAGO;PD;6043;10;7;0;17
046018;MASSAROSA;LU;21823;13;9;0;22
096031;MASSAZZA;BI;569;9;4;0;13
001145;MASSELLO;TO;57;10;3;0;13
096032;MASSERANO;BI;1916;7;6;0;13
044029;MASSIGNANO;AP;1635;10;3;0;13
022112;MASSIMENO;TN;144;12;3;0;15
009037;MASSIMINO;SV;97;10;1;0;11
003093;MASSINO VISCONTI;NO;1124;12;1;0;13
095026;MASULLAS;OR;1012;12;5;0;17
043024;MATELICA;MC;9290;13;9;0;22
077014;MATERA;MT;59748;26;16;0;42
001146;MATHI;TO;3777;14;3;0;17
075042;MATINO;LE;10993;13;10;0;23
070037;MATRICE;CB;1056;11;2;0;13
001147;MATTIE;TO;658;8;4;0;12
071031;MATTINATA;FG;6031;10;7;0;17
081012;MAZARA DEL VALLO;TP;50312;22;10;0;32
017107;MAZZANO;BS;12519;11;9;0;20
058058;MAZZANO ROMANO;RM;2969;7;10;0;17
085009;MAZZARINO;CL;11086;15;6;0;21
083046;MAZZARRA' SANT'ANDREA;ME;1400;8;4;0;12
087056;MAZZARRONE;CT;3955;11;6;0;17
001148;MAZZE';TO;4181;12;5;0;17
022113;MAZZIN;TN;588;9;6;0;15
014040;MAZZO DI VALTELLINA;SO;1028;6;7;0;13
001149;MEANA DI SUSA;TO;805;7;6;0;13
091047;MEANA SARDO;NU;1624;13;4;0;17
018088;MEDE;PV;6211;9;8;0;17
031011;MEDEA;GO;949;5;9;0;14
034020;MEDESANO;PR;10693;13;9;0;22
037037;MEDICINA;BO;16646;17;5;0;22
015139;MEDIGLIA;MI;12293;11;11;0;22
016250;MEDOLAGO;BG;2345;7;6;0;13
020034;MEDOLE;MN;4096;9;7;0;16
036021;MEDOLLA;MO;6352;8;9;0;17
026041;MEDUNA DI LIVENZA;TV;2947;4;9;0;13
093026;MEDUNO;PN;1504;7;9;0;16
028052;MEGLIADINO SAN VITALE;PD;1819;10;3;0;13
003095;MEINA;NO;2372;11;2;0;13
029032;MELARA;RO;1702;5;8;0;13
006092;MELAZZO;AL;1258;7;6;0;13
040019;MELDOLA;FC;9881;11;6;0;17
010033;MELE;GE;2592;9;4;0;13
015140;MELEGNANO;MI;17972;17;5;0;22
075043;MELENDUGNO;LE;9996;11;6;0;17
098038;MELETI;LO;445;6;7;0;13
076048;MELFI;PZ;17109;13;8;0;21
080048;MELICUCCA';RC;854;8;1;0;9
080049;MELICUCCO;RC;4889;11;6;0;17
089012;MELILLI;SR;13227;13;9;0;22
075044;MELISSANO;LE;6771;10;7;0;17
063045;MELITO DI NAPOLI;NA;36456;0;0;1;1
080050;MELITO DI PORTO SALVO;RC;10577;12;5;0;17
064048;MELITO IRPINO;AV;1797;10;3;0;13
062039;MELIZZANO;BN;1712;7;6;0;13
004122;MELLE;CN;298;8;5;0;13
014041;MELLO;SO;928;10;3;0;13
075045;MELPIGNANO;LE;2126;8;5;0;13
021050;MELTINA;BZ;1705;15;5;0;20
015142;MELZO;MI;18503;16;6;0;22
013145;MENAGGIO;CO;3035;11;6;0;17
018089;MENCONICO;PV;352;10;3;0;13
008034;MENDATICA;IM;162;8;5;0;13
078079;MENDICINO;CS;9208;0;0;1;1
084023;MENFI;AG;11929;12;10;0;22
058059;MENTANA;RM;22643;13;9;0;22
027022;MEOLO;VE;6229;9;8;0;17
006093;MERANA;AL;185;10;3;0;13
021051;MERANO;BZ;40759;27;15;0;42
097048;MERATE;LC;14661;15;7;0;22
012101;MERCALLO;VA;1797;6;7;0;13
041025;MERCATELLO SUL METAURO;PU;1317;11;2;0;13
041026;MERCATINO CONCA;PU;1005;10;3;0;13
065067;MERCATO SAN SEVERINO;SA;21679;13;9;0;22
040020;MERCATO SARACENO;FC;6812;10;7;0;17
001150;MERCENASCO;TO;1291;9;4;0;13
064049;MERCOGLIANO;AV;11635;13;9;0;22
030058;MERETO DI TOMBA;UD;2530;11;6;0;17
042024;MERGO;AN;1001;10;3;0;13
083047;MERI';ME;2322;7;8;0;15
028053;MERLARA;PD;2522;6;7;0;13
098039;MERLINO;LO;1726;8;5;0;13
013147;MERONE;CO;4058;7;4;0;11
074010;MESAGNE;BR;26114;19;3;0;22
014043;MESE;SO;1824;10;3;0;13
012102;MESENZANA;VA;1656;11;2;0;13
015144;MESERO;MI;4191;11;6;0;17
038014;MESOLA;FE;6511;10;7;0;17
083048;MESSINA;ME;221246;28;14;0;42
028054;MESTRINO;PD;11655;15;7;0;22
063046;META;NA;7862;12;5;0;17
022114;MEZZANA;TN;882;10;6;0;16
018090;MEZZANA BIGLI;PV;1051;9;4;0;13
096033;MEZZANA MORTIGLIENGO;BI;495;10;3;0;13
018091;MEZZANA RABATTONE;PV;467;8;5;0;13
023047;MEZZANE DI SOTTO;VR;2541;9;4;0;13
010034;MEZZANEGO;GE;1483;11;2;0;13
018092;MEZZANINO;PV;1320;7;5;0;12
022115;MEZZANO;TN;1596;14;6;0;20
001152;MEZZENILE;TO;736;10;3;0;13
022116;MEZZOCORONA;TN;5508;15;8;0;23
082047;MEZZOJUSO;PA;2682;10;7;0;17
016134;MEZZOLDO;BG;164;7;4;0;11
022117;MEZZOLOMBARDO;TN;7445;18;5;0;23
003097;MEZZOMERICO;NO;1203;7;6;0;13
096034;MIAGLIANO;BI;548;11;2;0;13
026042;MIANE;TV;3144;10;6;0;16
003098;MIASINO;NO;811;7;6;0;13
057037;MICIGLIANO;RI;115;12;1;0;13
075046;MIGGIANO;LE;3296;12;5;0;17
069050;MIGLIANICO;CH;4640;13;4;0;17
079077;MIGLIERINA;CZ;731;10;3;0;13
077015;MIGLIONICO;MT;2350;11;2;0;13
010035;MIGNANEGO;GE;3495;9;8;0;17
061051;MIGNANO MONTE LUNGO;CE;2999;14;3;0;17
015146;MILANO;MI;1349930;38;21;0;59
083049;MILAZZO;ME;30397;24;8;0;32
085010;MILENA;CL;2731;7;8;0;15
095027;MILIS;OR;1433;12;5;0;17
087025;MILITELLO IN VAL DI CATANIA;CT;6796;12;5;0;17
083050;MILITELLO ROSMARINO;ME;1174;9;6;0;15
009038;MILLESIMO;SV;3212;10;5;0;15
087026;MILO;CT;1038;8;7;0;15
017108;MILZANO;BS;1723;11;2;0;13
087027;MINEO;CT;4607;9;8;0;17
023048;MINERBE;VR;4534;12;5;0;17
037038;MINERBIO;BO;8854;11;6;0;17
075047;MINERVINO DI LECCE;LE;3500;11;6;0;17
065068;MINORI;SA;2596;9;3;0;12
059014;MINTURNO;LT;20215;16;7;0;23
046019;MINUCCIANO;LU;1826;11;2;0;13
009039;MIOGLIA;SV;490;12;1;0;13
027023;MIRA;VE;37576;21;11;0;32
064050;MIRABELLA ECLANO;AV;6732;10;7;0;17
087028;MIRABELLA IMBACCARI;CT;4280;10;7;0;17
006094;MIRABELLO MONFERRATO;AL;1211;8;3;0;11
070038;MIRABELLO SANNITICO;CB;2037;11;2;0;13
018093;MIRADOLO TERME;PV;3677;8;9;0;17
094027;MIRANDA;IS;957;9;4;0;13
036022;MIRANDOLA;MO;24135;13;9;0;22
027024;MIRANO;VE;27183;14;8;0;22
083051;MIRTO;ME;906;10;5;0;15
099005;MISANO ADRIATICO;RN;13913;11;11;0;22
016135;MISANO DI GERA D'ADDA;BG;2944;8;5;0;13
081025;MISILISCEMI;TP;8415;10;7;0;17
082048;MISILMERI;PA;28894;15;7;0;22
097049;MISSAGLIA;LC;8767;10;7;0;17
076049;MISSANELLO;PZ;483;6;7;0;13
087029;MISTERBIANCO;CT;49294;24;8;0;32
083052;MISTRETTA;ME;4388;12;5;0;17
005063;MOASCA;AT;514;11;2;0;13
010036;MOCONESI;GE;2437;11;2;0;13
036023;MODENA;MO;184971;20;22;0;42
088006;MODICA;RG;53554;20;12;0;32
040022;MODIGLIANA;FC;4326;7;10;0;17
095084;MODOLO;OR;155;9;5;0;14
072027;MODUGNO;BA;36539;21;11;0;32
022118;MOENA;TN;2589;16;4;0;20
097050;MOGGIO;LC;473;8;5;0;13
030059;MOGGIO UDINESE;UD;1621;10;6;0;16
020035;MOGLIA;MN;5353;9;8;0;17
043025;MOGLIANO;MC;4372;12;5;0;17
026043;MOGLIANO VENETO;TV;27626;15;7;0;22
095028;MOGORELLA;OR;412;10;2;0;12
095029;MOGORO;OR;3959;12;5;0;17
062040;MOIANO;BN;4052;12;5;0;17
030060;MOIMACCO;UD;1632;12;5;0;17
083053;MOIO ALCANTARA;ME;685;0;0;3;3
016136;MOIO DE' CALVI;BG;195;9;4;0;13
065069;MOIO DELLA CIVITELLA;SA;1802;8;5;0;13
004123;MOIOLA;CN;218;9;4;0;13
072028;MOLA DI BARI;BA;24625;18;4;0;22
006095;MOLARE;AL;2013;10;3;0;13
046020;MOLAZZANA;LU;1010;7;6;0;13
072029;MOLFETTA;BA;57645;19;13;0;32
066055;MOLINA ATERNO;AQ;354;12;1;0;13
062041;MOLINARA;BN;1471;9;4;0;13
037039;MOLINELLA;BO;15630;12;10;0;22
008035;MOLINI DI TRIORA;IM;622;7;6;0;13
006096;MOLINO DEI TORTI;AL;565;10;3;0;13
070039;MOLISE;CB;158;9;4;0;13
076050;MOLITERNO;PZ;3631;13;4;0;17
002078;MOLLIA;VC;93;10;3;0;13
080051;MOLOCHIO;RC;2262;10;3;0;13
097051;MOLTENO;LC;3534;10;6;0;16
013152;MOLTRASIO;CO;1544;8;5;0;13
022120;MOLVENO;TN;1097;16;4;0;20
005064;MOMBALDONE;AT;193;8;5;0;13
004124;MOMBARCARO;CN;250;7;6;0;13
041027;MOMBAROCCIO;PU;2063;9;3;0;12
005065;MOMBARUZZO;AT;986;7;6;0;13
004125;MOMBASIGLIO;CN;617;10;3;0;13
001153;MOMBELLO DI TORINO;TO;387;9;4;0;13
006097;MOMBELLO MONFERRATO;AL;925;10;3;0;13
005066;MOMBERCELLI;AT;2109;9;1;0;10
003100;MOMO;NO;2393;8;5;0;13
001154;MOMPANTERO;TO;642;10;3;0;13
057038;MOMPEO;RI;504;9;4;0;13
006098;MOMPERONE;AL;195;10;3;0;13
070040;MONACILIONI;CB;479;11;2;0;13
005067;MONALE;AT;984;7;6;0;13
080052;MONASTERACE;RC;3311;12;5;0;17
005068;MONASTERO BORMIDA;AT;872;7;4;0;11
001155;MONASTERO DI LANZO;TO;328;8;5;0;13
004126;MONASTERO DI VASCO;CN;1259;10;3;0;13
004127;MONASTEROLO CASOTTO;CN;80;8;5;0;13
016137;MONASTEROLO DEL CASTELLO;BG;1141;10;3;0;13
004128;MONASTEROLO DI SAVIGLIANO;CN;1335;10;3;0;13
026044;MONASTIER DI TREVISO;TV;4429;11;6;0;17
001156;MONCALIERI;TO;56193;24;8;0;32
005069;MONCALVO;AT;2745;13;4;0;17
001157;MONCENISIO;TO;41;10;3;0;13
006099;MONCESTINO;AL;196;10;3;0;13
004129;MONCHIERO;CN;585;9;4;0;13
034022;MONCHIO DELLE CORTI;PR;837;10;3;0;13
002079;MONCRIVELLO;VC;1376;8;5;0;13
005070;MONCUCCO TORINESE;AT;883;12;1;0;13
099006;MONDAINO;RN;1319;7;6;0;13
041028;MONDAVIO;PU;3658;11;6;0;17
041029;MONDOLFO;PU;14338;13;9;0;22
004130;MONDOVI';CN;22015;16;6;0;22
061052;MONDRAGONE;CE;28474;16;6;0;22
010037;MONEGLIA;GE;2589;10;3;0;13
004131;MONESIGLIO;CN;595;10;3;0;13
031012;MONFALCONE;GO;29072;22;11;0;33
004132;MONFORTE D'ALBA;CN;1954;9;4;0;13
083054;MONFORTE SAN GIORGIO;ME;2547;11;4;0;15
026045;MONFUMO;TV;1315;9;4;0;13
005071;MONGARDINO;AT;863;7;6;0;13
037040;MONGHIDORO;BO;3751;13;4;0;17
006100;MONGIARDINO LIGURE;AL;154;8;5;0;13
083055;MONGIUFFI MELIA;ME;537;10;5;0;15
096035;MONGRANDO;BI;3667;11;6;0;17
078080;MONGRASSANO;CS;1479;12;1;0;13
021052;MONGUELFO-TESIDO;BZ;2880;15;5;0;20
013153;MONGUZZO;CO;2367;7;3;2;12
017109;MONIGA DEL GARDA;BS;2603;8;5;0;13
006101;MONLEALE;AL;553;7;6;0;13
017110;MONNO;BS;515;8;0;0;8
072030;MONOPOLI;BA;48078;19;13;0;32
082049;MONREALE;PA;38665;27;5;0;32
032002;MONRUPINO;TS;857;7;7;0;14
044031;MONSAMPOLO DEL TRONTO;AP;4449;13;4;0;17
042025;MONSANO;AN;3310;11;6;0;17
028055;MONSELICE;PD;17242;14;8;0;22
092109;MONSERRATO;CA;19118;11;15;0;26
047009;MONSUMMANO TERME;PT;20821;15;7;0;22
004133;MONTA';CN;4684;10;7;0;17
005072;MONTABONE;AT;311;8;5;0;13
006102;MONTACUTO;AL;251;10;3;0;13
005073;MONTAFIA;AT;927;7;6;0;13
070041;MONTAGANO;CB;1008;11;2;0;13
014044;MONTAGNA IN VALTELLINA;SO;2963;9;8;0;17
021053;MONTAGNA SULLA STRADA DEL VINO;BZ;1690;14;6;0;20
028056;MONTAGNANA;PD;8898;9;8;0;17
083056;MONTAGNAREALE;ME;1419;9;6;0;15
064051;MONTAGUTO;AV;350;9;4;0;13
048027;MONTAIONE;FI;3499;11;6;0;17
083057;MONTALBANO ELICONA;ME;2021;10;5;0;15
077016;MONTALBANO JONICO;MT;6796;10;7;0;17
052037;MONTALCINO;SI;5676;10;7;0;17
006103;MONTALDEO;AL;232;10;3;0;13
006104;MONTALDO BORMIDA;AL;608;9;4;0;13
004134;MONTALDO DI MONDOVI';CN;530;9;4;0;13
004135;MONTALDO ROERO;CN;862;10;3;0;13
005074;MONTALDO SCARAMPI;AT;699;11;2;0;13
001158;MONTALDO TORINESE;TO;736;9;4;0;13
047010;MONTALE;PT;10608;13;9;0;22
001159;MONTALENGHE;TO;970;10;3;0;13
084024;MONTALLEGRO;AG;2394;10;5;0;15
008068;MONTALTO CARPASIO;IM;502;8;5;0;13
044032;MONTALTO DELLE MARCHE;AP;1939;9;4;0;13
056035;MONTALTO DI CASTRO;VT;8795;9;8;0;17
001160;MONTALTO DORA;TO;3304;9;8;0;17
018094;MONTALTO PAVESE;PV;860;7;6;0;13
078081;MONTALTO UFFUGO;CS;20159;14;8;0;22
001161;MONTANARO;TO;5118;11;6;0;17
098040;MONTANASO LOMBARDO;LO;2234;8;5;0;13
004136;MONTANERA;CN;714;10;3;0;13
065070;MONTANO ANTILIA;SA;1731;11;2;0;13
013154;MONTANO LUCINO;CO;5340;12;3;0;15
094028;MONTAQUILA;IS;2303;10;3;0;13
057039;MONTASOLA;RI;404;10;3;0;13
079080;MONTAURO;CZ;1771;11;2;0;13
069051;MONTAZZOLI;CH;859;8;5;0;13
053016;MONTE ARGENTARIO;GR;12040;12;10;0;22
054029;MONTE CASTELLO DI VIBIO;PG;1450;8;4;0;12
043027;MONTE CAVALLO;MC;104;8;5;0;13
041031;MONTE CERIGNONE;PU;620;10;2;0;12
058060;MONTE COMPATRI;RM;11899;14;8;0;22
019058;MONTE CREMASCO;CR;2241;9;3;0;12
024063;MONTE DI MALO;VI;2797;8;5;0;13
063047;MONTE DI PROCIDA;NA;11929;13;9;0;22
041035;MONTE GRIMANO TERME;PU;1066;9;4;0;13
017111;MONTE ISOLA;BS;1628;11;2;0;13
097052;MONTE MARENZO;LC;1868;10;3;0;13
041038;MONTE PORZIO;PU;2752;8;5;0;13
058064;MONTE PORZIO CATONE;RM;8584;10;7;0;17
042029;MONTE ROBERTO;AN;3018;12;5;0;17
056037;MONTE ROMANO;VT;1915;10;3;0;13
059015;MONTE SAN BIAGIO;LT;6104;10;7;0;17
065075;MONTE SAN GIACOMO;SA;1436;11;2;0;13
060044;MONTE SAN GIOVANNI CAMPANO;FR;12139;15;7;0;22
057043;MONTE SAN GIOVANNI IN SABINA;RI;655;9;3;0;12
043031;MONTE SAN GIUSTO;MC;7530;7;10;0;17
043032;MONTE SAN MARTINO;MC;709;9;4;0;13
037042;MONTE SAN PIETRO;BO;10764;11;11;0;22
051025;MONTE SAN SAVINO;AR;8615;8;9;0;17
042030;MONTE SAN VITO;AN;6728;7;10;0;17
071033;MONTE SANT'ANGELO;FG;11508;13;9;0;22
054032;MONTE SANTA MARIA TIBERINA;PG;1112;11;2;0;13
018095;MONTEBELLO DELLA BATTAGLIA;PV;1467;9;4;0;13
068023;MONTEBELLO DI BERTONA;PE;883;11;2;0;13
080053;MONTEBELLO JONICO;RC;5721;9;8;0;17
069009;MONTEBELLO SUL SANGRO;CH;74;9;4;0;13
024060;MONTEBELLO VICENTINO;VI;6319;10;6;0;16
026046;MONTEBELLUNA;TV;31062;21;11;0;32
010038;MONTEBRUNO;GE;207;8;5;0;13
057040;MONTEBUONO;RI;835;6;7;0;13
041030;MONTECALVO IN FOGLIA;PU;2698;6;7;0;13
064052;MONTECALVO IRPINO;AV;3380;10;7;0;17
018096;MONTECALVO VERSIGGIA;PV;516;11;1;0;12
046021;MONTECARLO;LU;4366;13;4;0;17
042026;MONTECAROTTO;AN;1860;8;5;0;13
043026;MONTECASSIANO;MC;6878;9;8;0;17
006105;MONTECASTELLO;AL;290;11;2;0;13
055017;MONTECASTRILLI;TR;4820;10;7;0;17
050019;MONTECATINI VAL DI CECINA;PI;1669;8;5;0;13
047011;MONTECATINI-TERME;PT;20468;15;7;0;22
023049;MONTECCHIA DI CROSARA;VR;4218;13;4;0;17
055018;MONTECCHIO;TR;1559;8;5;0;13
035027;MONTECCHIO EMILIA;RE;10384;13;9;0;22
024061;MONTECCHIO MAGGIORE;VI;23216;14;8;0;22
024062;MONTECCHIO PRECALCINO;VI;4907;9;8;0;17
006106;MONTECHIARO D'ACQUI;AL;501;9;4;0;13
005075;MONTECHIARO D'ASTI;AT;1206;13;0;0;13
034023;MONTECHIARUGOLO;PR;11154;11;11;0;22
070042;MONTECILFONE;CB;1204;10;3;0;13
099030;MONTECOPIOLO;RN;1035;7;5;0;12
065071;MONTECORICE;SA;2553;10;3;0;13
065072;MONTECORVINO PUGLIANO;SA;11108;13;9;0;22
065073;MONTECORVINO ROVELLA;SA;12318;14;8;0;22
043028;MONTECOSARO;MC;7303;11;6;0;17
036024;MONTECRETO;MO;919;6;7;0;13
044034;MONTEDINOVE;AP;472;10;3;0;13
085011;MONTEDORO;CL;1419;10;5;0;15
064053;MONTEFALCIONE;AV;3141;9;8;0;17
054030;MONTEFALCO;PG;5421;10;7;0;17
062042;MONTEFALCONE DI VAL FORTORE;BN;1335;10;3;0;13
070043;MONTEFALCONE NEL SANNIO;CB;1399;7;6;0;13
043029;MONTEFANO;MC;3302;10;7;0;17
041034;MONTEFELCINO;PU;2509;9;4;0;13
069052;MONTEFERRANTE;CH;111;8;5;0;13
056036;MONTEFIASCONE;VT;13020;11;11;0;22
067027;MONTEFINO;TE;967;11;2;0;13
099008;MONTEFIORE CONCA;RN;2237;8;5;0;13
044036;MONTEFIORE DELL'ASO;AP;1980;8;4;0;12
036025;MONTEFIORINO;MO;2085;11;2;0;13
058061;MONTEFLAVIO;RM;1195;7;6;0;13
065074;MONTEFORTE CILENTO;SA;539;10;3;0;13
023050;MONTEFORTE D'ALPONE;VR;9006;9;8;0;17
064054;MONTEFORTE IRPINO;AV;11428;12;10;0;22
055019;MONTEFRANCO;TR;1263;9;4;0;13
064055;MONTEFREDANE;AV;2134;11;2;0;13
064056;MONTEFUSCO;AV;1212;10;3;0;13
055020;MONTEGABBIONE;TR;1120;6;6;0;12
024064;MONTEGALDA;VI;3376;11;6;0;17
024065;MONTEGALDELLA;VI;1785;10;3;0;13
044038;MONTEGALLO;AP;448;12;1;0;13
006107;MONTEGIOCO;AL;284;6;7;0;13
078082;MONTEGIORDANO;CS;1595;9;4;0;13
099009;MONTEGRIDOLFO;RN;991;11;2;0;13
012103;MONTEGRINO VALTRAVAGLIA;VA;1491;12;1;0;13
005076;MONTEGROSSO D'ASTI;AT;2290;8;5;0;13
008037;MONTEGROSSO PIAN LATTE;IM;120;11;2;0;13
028057;MONTEGROTTO TERME;PD;11362;13;9;0;22
073016;MONTEIASI;TA;5377;11;6;0;17
041036;MONTELABBATE;PU;7006;10;7;0;17
058062;MONTELANICO;RM;2066;10;3;0;13
069053;MONTELAPIANO;CH;77;10;3;0;13
055021;MONTELEONE D'ORVIETO;TR;1369;7;6;0;13
071032;MONTELEONE DI PUGLIA;FG;959;10;3;0;13
054031;MONTELEONE DI SPOLETO;PG;567;9;4;0;13
090040;MONTELEONE ROCCA DORIA;SS;111;5;9;0;14
057041;MONTELEONE SABINO;RI;1197;10;3;0;13
082050;MONTELEPRE;PA;5857;8;10;0;18
058063;MONTELIBRETTI;RM;5140;9;8;0;17
064057;MONTELLA;AV;7367;10;7;0;17
016139;MONTELLO;BG;3176;9;8;0;17
070044;MONTELONGO;CB;315;11;2;0;13
004137;MONTELUPO ALBESE;CN;480;9;4;0;13
048028;MONTELUPO FIORENTINO;FI;14226;14;8;0;22
043030;MONTELUPONE;MC;3392;13;4;0;17
082051;MONTEMAGGIORE BELSITO;PA;2990;8;7;0;15
005077;MONTEMAGNO;AT;1053;8;5;0;13
004138;MONTEMALE DI CUNEO;CN;214;10;2;0;12
064058;MONTEMARANO;AV;2636;12;5;0;17
042027;MONTEMARCIANO;AN;9754;14;8;0;22
006108;MONTEMARZINO;AL;311;9;4;0;13
073017;MONTEMESOLA;TA;3608;13;4;0;17
013155;MONTEMEZZO;CO;220;7;6;0;13
051023;MONTEMIGNAIO;AR;523;8;5;0;13
064059;MONTEMILETTO;AV;5067;8;9;0;17
076051;MONTEMILONE;PZ;1402;8;5;0;13
070045;MONTEMITRO;CB;299;11;2;0;13
044044;MONTEMONACO;AP;528;8;5;0;13
076052;MONTEMURRO;PZ;1120;10;3;0;13
030061;MONTENARS;UD;483;8;5;0;13
070046;MONTENERO DI BISACCIA;CB;6191;9;8;0;17
057042;MONTENERO SABINO;RI;280;7;6;0;13
094029;MONTENERO VAL COCCHIARA;IS;503;8;5;0;13
069054;MONTENERODOMO;CH;604;10;3;0;13
069055;MONTEODORISIO;CH;2348;8;5;0;13
079081;MONTEPAONE;CZ;5614;12;5;0;17
073018;MONTEPARANO;TA;2315;11;2;0;13
044045;MONTEPRANDONE;AP;12869;14;8;0;22
052015;MONTEPULCIANO;SI;13386;12;10;0;22
051024;MONTERCHI;AR;1708;8;5;0;13
066056;MONTEREALE;AQ;2200;13;0;0;13
093027;MONTEREALE VALCELLINA;PN;4267;12;10;0;22
037041;MONTERENZIO;BO;6161;11;5;0;16
052016;MONTERIGGIONI;SI;9993;10;7;0;17
094030;MONTERODUNI;IS;2037;7;6;0;13
052017;MONTERONI D'ARBIA;SI;8984;10;7;0;17
075048;MONTERONI DI LECCE;LE;13425;13;9;0;22
056038;MONTEROSI;VT;4775;11;6;0;17
011019;MONTEROSSO AL MARE;SP;1371;12;1;0;13
088007;MONTEROSSO ALMO;RG;2821;9;8;0;17
004139;MONTEROSSO GRANA;CN;514;7;6;0;13
058065;MONTEROTONDO;RM;41060;18;14;0;32
053027;MONTEROTONDO MARITTIMO;GR;1283;7;6;0;13
075049;MONTESANO SALENTINO;LE;2599;13;0;0;13
065076;MONTESANO SULLA MARCELLANA;SA;6275;8;9;0;17
062043;MONTESARCHIO;BN;13001;12;10;0;22
077017;MONTESCAGLIOSO;MT;9247;13;9;0;22
018097;MONTESCANO;PV;416;7;6;0;13
050020;MONTESCUDAIO;PI;2167;9;4;0;13
099029;MONTESCUDO - MONTE COLOMBO;RN;6782;11;6;0;17
036026;MONTESE;MO;3222;9;8;0;17
018098;MONTESEGALE;PV;263;11;2;0;13
068024;MONTESILVANO;PE;53402;24;9;0;33
048030;MONTESPERTOLI;FI;13236;11;10;0;21
001162;MONTEU DA PO;TO;858;4;8;0;12
004140;MONTEU ROERO;CN;1634;10;2;0;12
084025;MONTEVAGO;AG;2743;11;6;0;17
051026;MONTEVARCHI;AR;24047;12;10;0;22
097053;MONTEVECCHIA;LC;2677;5;8;0;13
064060;MONTEVERDE;AV;714;7;6;0;13
050021;MONTEVERDI MARITTIMO;PI;753;9;4;0;13
024066;MONTEVIALE;VI;2801;10;3;0;13
004141;MONTEZEMOLO;CN;225;9;4;0;13
090041;MONTI;SS;2348;13;4;0;17
040028;MONTIANO;FC;1683;10;3;0;13
017112;MONTICELLI BRUSATI;BS;4568;11;6;0;17
033027;MONTICELLI D'ONGINA;PC;5106;9;8;0;17
018099;MONTICELLI PAVESE;PV;631;6;7;0;13
097054;MONTICELLO BRIANZA;LC;4153;12;5;0;17
024067;MONTICELLO CONTE OTTO;VI;8983;10;7;0;17
004142;MONTICELLO D'ALBA;CN;2351;10;3;0;13
017113;MONTICHIARI;BS;26088;11;10;0;21
052018;MONTICIANO;SI;1534;7;6;0;13
053017;MONTIERI;GR;1173;9;4;0;13
005121;MONTIGLIO MONFERRATO;AT;1516;9;4;0;13
045011;MONTIGNOSO;MS;10122;14;8;0;22
017114;MONTIRONE;BS;5064;10;7;0;17
007043;MONTJOVET;AO;1766;9;9;0;18
019059;MONTODINE;CR;2441;8;5;0;13
010039;MONTOGGIO;GE;2008;9;4;0;13
054033;MONTONE;PG;1579;9;4;0;13
057044;MONTOPOLI DI SABINA;RI;4103;10;7;0;17
050022;MONTOPOLI IN VAL D'ARNO;PI;11109;10;12;0;22
013157;MONTORFANO;CO;2516;9;4;0;13
067028;MONTORIO AL VOMANO;TE;7528;9;8;0;17
070047;MONTORIO NEI FRENTANI;CB;366;8;4;0;12
058066;MONTORIO ROMANO;RM;1939;9;4;0;13
064121;MONTORO;AV;19396;16;6;0;22
024068;MONTORSO VICENTINO;VI;3031;10;7;0;17
095085;MONTRESTA;OR;440;9;5;0;14
018100;MONTU' BECCARIA;PV;1618;9;4;0;13
012104;MONVALLE;VA;1939;9;4;0;13
020036;MONZAMBANO;MN;4859;10;7;0;17
037044;MONZUNO;BO;6358;9;8;0;17
078083;MORANO CALABRO;CS;3944;12;5;0;17
006109;MORANO SUL PO;AL;1319;7;5;0;12
005122;MORANSENGO-TONENGO;AT;397;9;4;0;13
031013;MORARO;GO;695;9;4;0;13
012105;MORAZZONE;VA;4278;11;6;0;17
014045;MORBEGNO;SO;12227;13;9;0;22
006110;MORBELLO;AL;389;8;5;0;13
075050;MORCIANO DI LEUCA;LE;3049;12;5;0;17
099011;MORCIANO DI ROMAGNA;RN;7139;11;6;0;17
062044;MORCONE;BN;4548;13;4;0;17
037045;MORDANO;BO;4591;13;4;0;17
016140;MORENGO;BG;2488;10;3;0;13
090042;MORES;SS;1758;12;5;0;17
004143;MORETTA;CN;4078;10;7;0;17
033028;MORFASSO;PC;888;11;2;0;13
026047;MORGANO;TV;4428;11;6;0;17
007044;MORGEX;AO;2058;13;5;0;18
095030;MORGONGIORI;OR;661;8;6;0;14
022123;MORI;TN;10048;16;8;0;24
026048;MORIAGO DELLA BATTAGLIA;TV;2783;8;5;0;13
058067;MORICONE;RM;2469;8;5;0;13
065077;MORIGERATI;SA;610;9;4;0;13
015150;MORIMONDO;MI;1024;11;2;0;13
066057;MORINO;AQ;1316;6;7;0;13
001163;MORIONDO TORINESE;TO;853;8;5;0;13
058068;MORLUPO;RM;8488;9;8;0;17
078084;MORMANNO;CS;2671;13;4;0;17
012106;MORNAGO;VA;4926;13;4;0;17
006111;MORNESE;AL;710;11;2;0;13
016141;MORNICO AL SERIO;BG;2914;12;1;0;13
018101;MORNICO LOSANA;PV;590;6;4;0;10
060045;MOROLO;FR;3182;10;7;0;17
004144;MOROZZO;CN;2000;8;5;0;13
064063;MORRA DE SANCTIS;AV;1133;8;5;0;13
042031;MORRO D'ALBA;AN;1803;7;6;0;13
067029;MORRO D'ORO;TE;3560;10;7;0;17
057045;MORRO REATINO;RI;328;10;3;0;13
070048;MORRONE DEL SANNIO;CB;533;10;3;0;13
043033;MORROVALLE;MC;9882;13;8;0;21
093028;MORSANO AL TAGLIAMENTO;PN;2680;9;8;0;17
006112;MORSASCO;AL;606;7;5;0;12
018102;MORTARA;PV;15300;13;9;0;22
030062;MORTEGLIANO;UD;4814;12;10;0;22
097055;MORTERONE;LC;31;11;2;0;13
030063;MORUZZO;UD;2452;11;6;0;17
019060;MOSCAZZANO;CR;714;7;5;0;12
064064;MOSCHIANO;AV;1553;13;0;0;13
067030;MOSCIANO SANT'ANGELO;TE;9088;9;8;0;17
068025;MOSCUFO;PE;3092;12;5;0;17
021054;MOSO IN PASSIRIA;BZ;2046;16;3;0;19
031014;MOSSA;GO;1522;10;7;0;17
019061;MOTTA BALUFFI;CR;796;6;8;0;14
083058;MOTTA CAMASTRA;ME;811;11;4;0;15
083059;MOTTA D'AFFERMO;ME;672;9;6;0;15
002082;MOTTA DE' CONTI;VC;741;5;6;0;11
026049;MOTTA DI LIVENZA;TV;10661;10;12;0;22
071034;MOTTA MONTECORVINO;FG;655;8;5;0;13
080054;MOTTA SAN GIOVANNI;RC;5672;10;7;0;17
087030;MOTTA SANT'ANASTASIA;CT;12054;13;9;0;22
079083;MOTTA SANTA LUCIA;CZ;789;9;4;0;13
015151;MOTTA VISCONTI;MI;8120;11;6;0;17
078085;MOTTAFOLLONE;CS;1094;11;2;0;13
096037;MOTTALCIATA;BI;1332;8;5;0;13
020037;MOTTEGGIANA;MN;2458;11;2;0;13
073019;MOTTOLA;TA;15419;14;6;0;20
069056;MOZZAGROGNA;CH;2426;11;2;0;13
016142;MOZZANICA;BG;4349;10;7;0;17
013159;MOZZATE;CO;8677;9;7;0;16
023051;MOZZECANE;VR;8045;9;8;0;17
016143;MOZZO;BG;7311;9;8;0;17
043034;MUCCIA;MC;823;9;4;0;13
032003;MUGGIA;TS;12916;20;7;0;27
064065;MUGNANO DEL CARDINALE;AV;5145;10;7;0;17
063048;MUGNANO DI NAPOLI;NA;34578;23;9;0;32
098041;MULAZZANO;LO;5834;10;7;0;17
045012;MULAZZO;MS;2288;9;4;0;13
017115;MURA;BS;774;8;5;0;13
004145;MURAZZANO;CN;830;6;6;0;12
004146;MURELLO;CN;937;10;3;0;13
009040;MURIALDO;SV;773;11;2;0;13
006113;MURISENGO;AL;1291;9;4;0;13
052019;MURLO;SI;2408;8;5;0;13
075051;MURO LECCESE;LE;4765;10;7;0;17
076053;MURO LUCANO;PZ;4960;13;4;0;17
090043;MUROS;SS;830;7;6;0;13
017116;MUSCOLINE;BS;2680;9;4;0;13
027025;MUSILE DI PIAVE;VE;11326;12;9;0;21
013160;MUSSO;CO;934;11;2;0;13
024070;MUSSOLENTE;VI;7634;11;6;0;17
085012;MUSSOMELI;CL;10011;13;9;0;22
030064;MUZZANA DEL TURGNANO;UD;2360;9;8;0;17
096038;MUZZANO;BI;578;11;2;0;13
022124;NAGO-TORBOLE;TN;2822;18;2;0;20
021055;NALLES;BZ;2075;15;5;0;20
024071;NANTO;VI;3105;12;5;0;17
063049;NAPOLI;NA;921142;37;14;0;51
095031;NARBOLIA;OR;1692;12;5;0;17
075052;NARDO';LE;30790;24;8;0;32
055022;NARNI;TR;18258;13;9;0;22
084026;NARO;AG;7051;9;8;0;17
004147;NARZOLE;CN;3493;10;7;0;17
009041;NASINO;SV;174;10;3;0;13
083060;NASO;ME;3513;8;8;0;16
021056;NATURNO;BZ;6015;16;8;0;24
017117;NAVE;BS;10640;13;9;0;22
066058;NAVELLI;AQ;499;10;3;0;13
021057;NAZ-SCIAVES;BZ;3281;15;5;0;20
058069;NAZZANO;RM;1367;7;6;0;13
010040;NE;GE;2130;8;5;0;13
003103;NEBBIUNO;NO;1788;10;3;0;13
023052;NEGRAR DI VALPOLICELLA;VR;16651;14;6;0;20
010041;NEIRONE;GE;843;8;5;0;13
004148;NEIVE;CN;3328;11;6;0;17
016144;NEMBRO;BG;11222;13;9;0;22
058070;NEMI;RM;1890;9;4;0;13
076054;NEMOLI;PZ;1404;10;3;0;13
095032;NEONELI;OR;622;5;9;0;14
056039;NEPI;VT;9318;11;6;0;17
067031;NERETO;TE;5274;10;7;0;17
058071;NEROLA;RM;1897;7;6;0;13
026050;NERVESA DELLA BATTAGLIA;TV;6543;9;8;0;17
015154;NERVIANO;MI;16928;13;9;0;22
057046;NESPOLO;RI;191;7;6;0;13
013161;NESSO;CO;1163;9;4;0;13
096039;NETRO;BI;939;9;4;0;13
058072;NETTUNO;RM;48159;0;0;3;3
075053;NEVIANO;LE;4954;0;0;3;3
034024;NEVIANO DEGLI ARDUINI;PR;3428;13;4;0;17
004149;NEVIGLIE;CN;367;10;2;0;12
017118;NIARDO;BS;1968;10;3;0;13
003104;NIBBIOLA;NO;825;8;5;0;13
097056;NIBIONNO;LC;3600;11;6;0;17
001164;NICHELINO;TO;46458;19;12;0;31
087031;NICOLOSI;CT;7596;11;7;0;18
018103;NICORVO;PV;277;9;4;0;13
086012;NICOSIA;EN;12877;12;10;0;22
004150;NIELLA BELBO;CN;347;10;3;0;13
004151;NIELLA TANARO;CN;956;10;3;0;13
030065;NIMIS;UD;2558;11;6;0;17
085013;NISCEMI;CL;25179;18;4;0;22
086013;NISSORIA;EN;2861;8;7;0;15
083061;NIZZA DI SICILIA;ME;3543;10;7;0;17
005080;NIZZA MONFERRATO;AT;10094;13;9;0;22
027026;NOALE;VE;16128;14;8;0;22
001165;NOASCA;TO;107;9;4;0;13
078086;NOCARA;CS;325;7;6;0;13
068026;NOCCIANO;PE;1725;11;2;0;13
065078;NOCERA INFERIORE;SA;44331;24;8;0;32
065079;NOCERA SUPERIORE;SA;23842;16;4;0;20
079087;NOCERA TERINESE;CZ;4719;0;0;3;3
054034;NOCERA UMBRA;PG;5584;9;8;0;17
034025;NOCETO;PR;13115;14;8;0;22
072031;NOCI;BA;18444;16;6;0;22
075054;NOCIGLIA;LE;2159;7;6;0;13
076055;NOEPOLI;PZ;766;0;0;1;1
023053;NOGARA;VR;8343;8;9;0;17
022127;NOGAREDO;TN;2055;10;10;0;20
023054;NOGAROLE ROCCA;VR;3835;11;6;0;17
024072;NOGAROLE VICENTINO;VI;1219;9;4;0;13
072032;NOICATTARO;BA;26016;13;9;0;22
063050;NOLA;NA;33619;21;9;0;30
001166;NOLE;TO;6803;11;6;0;17
009042;NOLI;SV;2442;7;6;0;13
001167;NOMAGLIO;TO;283;8;5;0;13
022128;NOMI;TN;1302;12;8;0;20
036027;NONANTOLA;MO;16022;15;6;0;21
001168;NONE;TO;7830;10;7;0;17
091050;NORAGUGUME;NU;286;5;8;0;13
095033;NORBELLO;OR;1141;10;7;0;17
054035;NORCIA;PG;4556;13;4;0;17
059016;NORMA;LT;3675;13;4;0;17
015155;NOSATE;MI;636;8;5;0;13
067032;NOTARESCO;TE;6387;11;6;0;17
089013;NOTO;SR;23905;18;4;0;22
021058;NOVA LEVANTE;BZ;2023;13;7;0;20
021059;NOVA PONENTE;BZ;4016;15;9;0;24
077018;NOVA SIRI;MT;6708;10;7;0;17
099023;NOVAFELTRIA;RN;6962;8;9;0;17
022129;NOVALEDO;TN;1101;10;8;0;18
001169;NOVALESA;TO;516;9;4;0;13
003106;NOVARA;NO;101367;27;15;0;42
083062;NOVARA DI SICILIA;ME;1186;10;5;0;15
014046;NOVATE MEZZOLA;SO;1883;9;4;0;13
015157;NOVATE MILANESE;MI;19877;10;12;0;22
024073;NOVE;VI;4894;9;8;0;17
013163;NOVEDRATE;CO;2880;9;4;0;13
022253;NOVELLA;TN;3581;16;7;0;23
035028;NOVELLARA;RE;13337;10;12;0;22
004152;NOVELLO;CN;960;9;4;0;13
027027;NOVENTA DI PIAVE;VE;6952;11;6;0;17
028058;NOVENTA PADOVANA;PD;11524;12;10;0;22
024074;NOVENTA VICENTINA;VI;8929;11;6;0;17
036028;NOVI DI MODENA;MO;10001;14;8;0;22
006114;NOVI LIGURE;AL;27449;14;8;0;22
065080;NOVI VELIA;SA;2312;10;3;0;13
015158;NOVIGLIO;MI;4528;11;6;0;17
075055;NOVOLI;LE;7639;9;8;0;17
004153;NUCETTO;CN;393;10;3;0;13
090044;NUGHEDU SAN NICOLO';SS;763;8;4;0;12
095034;NUGHEDU SANTA VITTORIA;OR;441;9;5;0;14
090045;NULE;SS;1293;12;5;0;17
090046;NULVI;SS;2648;9;8;0;17
042032;NUMANA;AN;3757;8;9;0;17
091051;NUORO;NU;34183;18;14;0;32
095035;NURACHI;OR;1692;9;8;0;17
095036;NURECI;OR;320;11;3;0;14
007045;NUS;AO;2988;11;7;0;18
064066;NUSCO;AV;3918;12;5;0;17
017119;NUVOLENTO;BS;3865;7;9;0;16
017120;NUVOLERA;BS;4695;11;6;0;17
096040;OCCHIEPPO INFERIORE;BI;3753;10;7;0;17
096041;OCCHIEPPO SUPERIORE;BI;2638;11;2;0;13
029033;OCCHIOBELLO;RO;12002;11;11;0;22
006115;OCCIMIANO;AL;1242;8;5;0;13
066059;OCRE;AQ;1099;9;4;0;13
006116;ODALENGO GRANDE;AL;407;10;3;0;13
006117;ODALENGO PICCOLO;AL;239;5;8;0;13
026051;ODERZO;TV;20042;12;10;0;22
017121;ODOLO;BS;1927;10;3;0;13
066060;OFENA;AQ;428;7;6;0;13
042033;OFFAGNA;AN;2037;8;5;0;13
019062;OFFANENGO;CR;5927;11;6;0;17
044054;OFFIDA;AP;4702;10;7;0;17
017122;OFFLAGA;BS;4117;11;6;0;17
012107;OGGIONA CON SANTO STEFANO;VA;4319;12;5;0;17
097057;OGGIONO;LC;9043;11;6;0;17
001170;OGLIANICO;TO;1455;10;3;0;13
065081;OGLIASTRO CILENTO;SA;2263;9;4;0;13
090047;OLBIA;SS;60711;24;13;0;37
002088;OLCENENGO;VC;787;9;4;0;13
002089;OLDENICO;VC;217;5;8;0;13
003108;OLEGGIO;NO;14204;13;9;0;22
003109;OLEGGIO CASTELLO;NO;2203;12;1;0;13
018104;OLEVANO DI LOMELLINA;PV;723;9;4;0;13
058073;OLEVANO ROMANO;RM;6404;12;5;0;17
065082;OLEVANO SUL TUSCIANO;SA;6536;10;7;0;17
013165;OLGIATE COMASCO;CO;11780;12;10;0;22
097058;OLGIATE MOLGORA;LC;6346;11;6;0;17
012108;OLGIATE OLONA;VA;12599;16;6;0;22
097059;OLGINATE;LC;6938;8;9;0;17
091055;OLIENA;NU;6657;12;10;0;22
018105;OLIVA GESSI;PV;170;11;2;0;13
079088;OLIVADI;CZ;482;6;7;0;13
083063;OLIVERI;ME;2048;7;6;0;13
065083;OLIVETO CITRA;SA;3650;11;6;0;17
097060;OLIVETO LARIO;LC;1199;10;3;0;13
077019;OLIVETO LUCANO;MT;366;7;4;0;11
008038;OLIVETTA SAN MICHELE;IM;201;11;2;0;13
006118;OLIVOLA;AL;114;9;2;0;11
095037;OLLASTRA;OR;1144;12;5;0;17
091056;OLLOLAI;NU;1202;12;5;0;17
007046;OLLOMONT;AO;158;7;4;0;11
090048;OLMEDO;SS;4134;12;5;0;17
019063;OLMENETA;CR;905;10;3;0;13
016145;OLMO AL BREMBO;BG;486;7;6;0;13
005081;OLMO GENTILE;AT;70;6;7;0;13
016146;OLTRE IL COLLE;BG;980;11;2;0;13
016147;OLTRESSENDA ALTA;BG;144;9;4;0;13
013169;OLTRONA DI SAN MAMETTE;CO;2373;6;7;0;13
091057;OLZAI;NU;774;7;7;0;14
017123;OME;BS;3152;9;7;0;16
065084;OMIGNANO;SA;1632;9;4;0;13
091058;ONANI';NU;373;5;5;0;10
056040;ONANO;VT;912;9;3;0;12
004154;ONCINO;CN;87;10;3;0;13
016148;ONETA;BG;571;9;4;0;13
091059;ONIFAI;NU;697;9;3;0;12
091060;ONIFERI;NU;873;8;6;0;14
017124;ONO SAN PIETRO;BS;965;7;6;0;13
016149;ONORE;BG;920;6;6;0;12
009043;ONZO;SV;219;7;6;0;13
015159;OPERA;MI;14152;11;11;0;22
066061;OPI;AQ;374;12;1;0;13
023055;OPPEANO;VR;10202;13;3;0;16
076056;OPPIDO LUCANO;PZ;3616;13;4;0;17
080055;OPPIDO MAMERTINA;RC;4859;11;6;0;17
021060;ORA;BZ;3859;17;7;0;24
091061;ORANI;NU;2723;7;8;0;15
070049;ORATINO;CB;1625;6;7;0;13
001171;ORBASSANO;TO;23044;15;7;0;22
053018;ORBETELLO;GR;14352;12;10;0;22
050023;ORCIANO PISANO;PI;633;8;2;0;10
009044;ORCO FEGLINO;SV;919;9;4;0;13
071063;ORDONA;FG;2820;10;3;0;13
010042;ORERO;GE;503;12;1;0;13
024075;ORGIANO;VI;3012;9;7;0;16
091062;ORGOSOLO;NU;3971;12;5;0;17
074011;ORIA;BR;14569;14;8;0;22
066062;ORICOLA;AQ;1251;12;1;0;13
012109;ORIGGIO;VA;7939;10;7;0;17
012110;ORINO;VA;819;7;4;0;11
016150;ORIO AL SERIO;BG;1667;8;5;0;13
001172;ORIO CANAVESE;TO;756;6;6;0;12
098042;ORIO LITTA;LO;2004;10;3;0;13
078087;ORIOLO;CS;1885;12;1;0;13
056041;ORIOLO ROMANO;VT;3728;10;7;0;17
095038;ORISTANO;OR;30653;24;8;0;32
004155;ORMEA;CN;1477;10;3;0;13
026052;ORMELLE;TV;4515;12;5;0;17
016151;ORNICA;BG;145;8;4;0;12
091063;OROSEI;NU;6833;11;11;0;22
091064;OROTELLI;NU;1905;11;5;0;16
065085;ORRIA;SA;993;13;0;0;13
026053;ORSAGO;TV;3850;9;8;0;17
006119;ORSARA BORMIDA;AL;400;10;3;0;13
071035;ORSARA DI PUGLIA;FG;2521;8;5;0;13
013170;ORSENIGO;CO;2649;10;3;0;13
069057;ORSOGNA;CH;3653;12;5;0;17
078088;ORSOMARSO;CS;1140;9;4;0;13
061053;ORTA DI ATELLA;CE;27118;0;0;1;1
071036;ORTA NOVA;FG;16869;1;2;1;4
003112;ORTA SAN GIULIO;NO;1131;8;5;0;13
056042;ORTE;VT;9055;9;8;0;17
075056;ORTELLE;LE;2234;13;0;0;13
051027;ORTIGNANO RAGGIOLO;AR;852;8;5;0;13
021061;ORTISEI;BZ;4833;15;9;0;24
069058;ORTONA;CH;22305;13;9;0;22
066063;ORTONA DEI MARSI;AQ;434;13;0;0;13
009045;ORTOVERO;SV;1599;9;4;0;13
066064;ORTUCCHIO;AQ;1774;12;1;0;13
091066;ORTUERI;NU;1049;9;6;0;15
091067;ORUNE;NU;2177;9;7;0;16
055023;ORVIETO;TR;19689;14;8;0;22
057047;ORVINIO;RI;398;12;1;0;13
017125;ORZINUOVI;BS;12372;14;8;0;22
017126;ORZIVECCHI;BS;2430;12;1;0;13
001173;OSASCO;TO;1153;11;2;0;13
001174;OSASIO;TO;936;10;3;0;13
090049;OSCHIRI;SS;3051;10;7;0;17
091068;OSIDDA;NU;219;5;7;0;12
009046;OSIGLIA;SV;443;9;4;0;13
090050;OSILO;SS;2834;12;5;0;17
042034;OSIMO;AN;34792;22;10;0;32
091069;OSINI;NU;727;7;5;0;12
016152;OSIO SOPRA;BG;5211;9;8;0;17
016153;OSIO SOTTO;BG;12487;16;6;0;22
097061;OSNAGO;LC;4742;8;9;0;17
030066;OSOPPO;UD;2826;12;10;0;22
008039;OSPEDALETTI;IM;3168;11;6;0;17
022130;OSPEDALETTO;TN;785;12;4;0;16
064067;OSPEDALETTO D'ALPINOLO;AV;2063;10;3;0;13
028059;OSPEDALETTO EUGANEO;PD;5543;10;7;0;17
098043;OSPEDALETTO LODIGIANO;LO;1953;7;6;0;13
025035;OSPITALE DI CADORE;BL;267;9;4;0;13
017127;OSPITALETTO;BS;14663;14;8;0;22
098044;OSSAGO LODIGIANO;LO;1415;8;5;0;13
022131;OSSANA;TN;822;10;6;0;16
090051;OSSI;SS;5513;12;10;0;22
017128;OSSIMO;BS;1452;9;4;0;13
015164;OSSONA;MI;4343;10;7;0;17
004156;OSTANA;CN;85;10;3;0;13
038017;OSTELLATO;FE;5719;10;7;0;17
019064;OSTIANO;CR;2699;12;5;0;17
020038;OSTIGLIA;MN;6583;9;6;0;15
042035;OSTRA;AN;6398;11;6;0;17
042036;OSTRA VETERE;AN;3141;7;10;0;17
074012;OSTUNI;BR;30302;20;12;0;32
075057;OTRANTO;LE;5715;7;10;0;17
055024;OTRICOLI;TR;1724;9;4;0;13
091070;OTTANA;NU;2199;8;7;0;15
065086;OTTATI;SA;631;11;2;0;13
063051;OTTAVIANO;NA;23064;13;9;0;22
006120;OTTIGLIO;AL;594;11;2;0;13
018106;OTTOBIANO;PV;1073;7;6;0;13
033030;OTTONE;PC;444;11;2;0;13
001175;OULX;TO;3293;9;8;0;17
006121;OVADA;AL;10873;12;10;0;22
030067;OVARO;UD;1752;10;7;0;17
006122;OVIGLIO;AL;1196;8;5;0;13
066065;OVINDOLI;AQ;1158;8;5;0;13
091071;OVODDA;NU;1536;7;8;0;15
007047;OYACE;AO;209;8;6;0;14
001176;OZEGNA;TO;1176;9;4;0;13
090052;OZIERI;SS;9935;14;8;0;22
037046;OZZANO DELL'EMILIA;BO;13922;11;11;0;22
006123;OZZANO MONFERRATO;AL;1366;7;3;0;10
015165;OZZERO;MI;1405;9;4;0;13
083064;PACE DEL MELA;ME;6011;12;5;0;17
066066;PACENTRO;AQ;1105;11;2;0;13
089014;PACHINO;SR;21678;15;7;0;22
054036;PACIANO;PG;952;9;4;0;13
017129;PADENGHE SUL GARDA;BS;4773;10;7;0;17
006124;PADERNA;AL;198;8;5;0;13
097062;PADERNO D'ADDA;LC;3846;12;5;0;17
015166;PADERNO DUGNANO;MI;47090;23;8;0;31
017130;PADERNO FRANCIACORTA;BS;3637;12;5;0;17
019065;PADERNO PONCHIELLI;CR;1345;7;6;0;13
028060;PADOVA;PD;206651;28;14;0;42
090053;PADRIA;SS;605;8;4;0;12
090090;PADRU;SS;2055;13;4;0;17
065087;PADULA;SA;4936;8;9;0;17
062045;PADULI;BN;3651;14;3;0;17
004157;PAESANA;CN;2637;10;3;0;13
026055;PAESE;TV;22012;14;8;0;22
065088;PAGANI;SA;34472;21;11;0;32
057048;PAGANICO SABINO;RI;148;6;6;0;12
016154;PAGAZZANO;BG;2098;10;3;0;13
083065;PAGLIARA;ME;1135;10;4;0;14
069059;PAGLIETA;CH;4154;10;7;0;17
030068;PAGNACCO;UD;5112;11;11;0;22
004158;PAGNO;CN;584;11;2;0;13
097063;PAGNONA;LC;328;9;4;0;13
064068;PAGO DEL VALLO DI LAURO;AV;1741;10;3;0;13
062046;PAGO VEIANO;BN;2304;7;1;0;8
017131;PAISCO LOVENO;BS;176;6;3;0;9
017132;PAITONE;BS;2170;9;4;0;13
016155;PALADINA;BG;3976;7;10;0;17
036029;PALAGANO;MO;2059;6;7;0;13
073020;PALAGIANELLO;TA;7627;9;8;0;17
073021;PALAGIANO;TA;15788;18;4;0;22
087032;PALAGONIA;CT;15802;0;0;3;3
050024;PALAIA;PI;4535;11;6;0;17
034026;PALANZANO;PR;1051;6;7;0;13
070050;PALATA;CB;1575;10;3;0;13
090054;PALAU;SS;4106;12;5;0;17
016156;PALAZZAGO;BG;4492;9;8;0;17
082052;PALAZZO ADRIANO;PA;1849;9;6;0;15
001177;PALAZZO CANAVESE;TO;839;7;6;0;13
019066;PALAZZO PIGNANO;CR;3777;11;5;0;16
076057;PALAZZO SAN GERVASIO;PZ;4511;10;7;0;17
089015;PALAZZOLO ACREIDE;SR;8233;13;5;0;18
030069;PALAZZOLO DELLO STELLA;UD;2891;13;8;0;21
017133;PALAZZOLO SULL'OGLIO;BS;19937;14;8;0;22
002090;PALAZZOLO VERCELLESE;VC;1105;7;3;0;10
048031;PALAZZUOLO SUL SENIO;FI;1111;12;1;0;13
069060;PALENA;CH;1251;9;4;0;13
079089;PALERMITI;CZ;1075;10;3;0;13
082053;PALERMO;PA;635439;37;15;0;52
058074;PALESTRINA;RM;22082;0;0;1;1
018107;PALESTRO;PV;1785;6;7;0;13
060046;PALIANO;FR;7951;10;7;0;17
080056;PALIZZI;RC;1993;9;4;0;13
009047;PALLARE;SV;900;8;5;0;13
063052;PALMA CAMPANIA;NA;16223;14;8;0;22
084027;PALMA DI MONTECHIARO;AG;21509;15;7;0;22
030070;PALMANOVA;UD;5288;13;10;0;23
075058;PALMARIGGI;LE;1403;9;4;0;13
095039;PALMAS ARBOREA;OR;1475;13;3;0;16
080057;PALMI;RC;17868;16;6;0;22
044056;PALMIANO;AP;163;11;2;0;13
069061;PALMOLI;CH;804;9;4;0;13
072033;PALO DEL COLLE;BA;20761;13;9;0;22
058075;PALOMBARA SABINA;RM;12882;12;10;0;22
069062;PALOMBARO;CH;961;7;6;0;13
065089;PALOMONTE;SA;3754;13;4;0;17
016157;PALOSCO;BG;5747;12;5;0;17
023056;PALU';VR;1216;7;5;0;12
022133;PALU' DEL FERSINA;TN;167;8;7;0;15
078089;PALUDI;CS;1014;11;2;0;13
030071;PALUZZA;UD;1995;9;6;0;15
004159;PAMPARATO;CN;270;11;2;0;13
001178;PANCALIERI;TO;1992;10;3;0;13
018108;PANCARANA;PV;315;9;4;0;13
022134;PANCHIA';TN;809;12;4;0;16
019067;PANDINO;CR;8908;8;9;0;17
078090;PANETTIERI;CS;316;9;4;0;13
054037;PANICALE;PG;5332;10;7;0;17
062047;PANNARANO;BN;1989;13;0;0;13
071037;PANNI;FG;714;10;3;0;13
081014;PANTELLERIA;TP;7407;11;7;0;18
015167;PANTIGLIATE;MI;5796;9;8;0;17
078091;PAOLA;CS;14827;13;9;0;22
062048;PAOLISI;BN;2007;12;1;0;13
078092;PAPASIDERO;CS;634;11;2;0;13
029034;PAPOZZE;RO;1355;8;5;0;13
015168;PARABIAGO;MI;27859;14;8;0;22
075059;PARABITA;LE;8741;11;6;0;17
017134;PARATICO;BS;4884;14;3;0;17
021062;PARCINES;BZ;3887;17;6;0;23
001179;PARELLA;TO;412;9;5;0;14
078093;PARENTI;CS;2031;10;3;0;13
061054;PARETE;CE;12192;11;10;0;21
006125;PARETO;AL;517;7;6;0;13
097064;PARLASCO;LC;136;9;3;0;12
034027;PARMA;PR;195436;25;17;0;42
006126;PARODI LIGURE;AL;614;12;1;0;13
004160;PAROLDO;CN;195;8;4;0;12
064069;PAROLISE;AV;638;10;3;0;13
018109;PARONA;PV;1849;10;3;0;13
055025;PARRANO;TR;485;10;3;0;13
016158;PARRE;BG;2698;12;1;0;13
082054;PARTINICO;PA;30844;23;9;0;32
003114;PARUZZARO;NO;2143;7;5;0;12
016159;PARZANICA;BG;345;10;3;0;13
030072;PASIAN DI PRATO;UD;9265;13;10;0;23
093029;PASIANO DI PORDENONE;PN;7760;10;12;0;22
017135;PASPARDO;BS;579;9;4;0;13
005082;PASSERANO MARMORITO;AT;432;10;1;0;11
054038;PASSIGNANO SUL TRASIMENO;PG;5662;10;7;0;17
017136;PASSIRANO;BS;6914;10;7;0;17
060047;PASTENA;FR;1284;11;2;0;13
061055;PASTORANO;CE;2899;11;2;0;13
023057;PASTRENGO;VR;3088;10;3;0;13
006127;PASTURANA;AL;1286;7;6;0;13
097065;PASTURO;LC;1933;12;1;0;13
076100;PATERNO;PZ;3069;12;5;0;17
078094;PATERNO CALABRO;CS;1350;9;4;0;13
087033;PATERNO';CT;45539;25;6;0;31
064070;PATERNOPOLI;AV;2158;9;4;0;13
060048;PATRICA;FR;3071;9;8;0;17
090055;PATTADA;SS;2892;10;7;0;17
083066;PATTI;ME;12802;12;10;0;22
075060;PATU';LE;1688;11;2;0;13
095040;PAU;OR;276;7;7;0;14
030073;PAULARO;UD;2373;12;5;0;17
095041;PAULILATINO;OR;2096;12;5;0;17
015169;PAULLO;MI;11108;12;10;0;22
062049;PAUPISI;BN;1432;9;4;0;13
001180;PAVAROLO;TO;1148;8;5;0;13
018110;PAVIA;PV;70380;26;15;0;41
030074;PAVIA DI UDINE;UD;5514;12;11;0;23
001181;PAVONE CANAVESE;TO;3635;10;7;0;17
017137;PAVONE DEL MELLA;BS;2706;4;9;0;13
036030;PAVULLO NEL FRIGNANO;MO;18042;15;6;0;21
080058;PAZZANO;RC;498;11;0;0;11
050025;PECCIOLI;PI;4666;9;8;0;17
006128;PECETTO DI VALENZA;AL;1166;8;5;0;13
001183;PECETTO TORINESE;TO;4046;11;6;0;17
087034;PEDARA;CT;14915;15;7;0;22
025036;PEDAVENA;BL;4328;10;6;0;16
024076;PEDEMONTE;VI;700;9;4;0;13
026056;PEDEROBBA;TV;7280;9;8;0;17
014047;PEDESINA;SO;35;11;2;0;13
078096;PEDIVIGLIANO;CS;744;10;3;0;13
016160;PEDRENGO;BG;5883;9;8;0;17
013178;PEGLIO;CO;189;10;3;0;13
041041;PEGLIO;PU;651;7;6;0;13
020039;PEGOGNAGA;MN;6888;8;9;0;17
016161;PEIA;BG;1720;12;1;0;13
022136;PEIO;TN;1820;15;4;0;19
048032;PELAGO;FI;7760;11;6;0;17
003115;PELLA;NO;894;8;5;0;13
034028;PELLEGRINO PARMENSE;PR;962;8;5;0;13
065090;PELLEZZANO;SA;10951;12;10;0;22
022137;PELLIZZANO;TN;772;8;7;0;15
022138;PELUGO;TN;396;10;6;0;16
005083;PENANGO;AT;445;9;3;0;12
055026;PENNA IN TEVERINA;TR;1029;10;3;0;13
043035;PENNA SAN GIOVANNI;MC;971;5;6;0;11
067033;PENNA SANT'ANDREA;TE;1635;9;4;0;13
099024;PENNABILLI;RN;2629;9;8;0;17
069063;PENNADOMO;CH;218;10;3;0;13
069064;PENNAPIEDIMONTE;CH;425;7;5;0;12
068027;PENNE;PE;11368;14;8;0;22
079092;PENTONE;CZ;1934;10;3;0;13
069065;PERANO;CH;1518;12;1;0;13
025037;PERAROLO DI CADORE;BL;373;10;2;0;12
021063;PERCA;BZ;1656;17;3;0;20
058076;PERCILE;RM;215;8;3;0;11
091072;PERDASDEFOGU;NU;1763;14;3;0;17
065091;PERDIFUMO;SA;1758;0;0;1;1
066067;PERETO;AQ;638;11;2;0;13
090056;PERFUGAS;SS;2272;12;5;0;17
022139;PERGINE VALSUGANA;TN;21483;20;9;0;29
041043;PERGOLA;PU;5830;11;6;0;17
008040;PERINALDO;IM;845;10;3;0;13
065092;PERITO;SA;829;12;1;0;13
097067;PERLEDO;LC;864;8;5;0;13
004161;PERLETTO;CN;260;11;2;0;13
004162;PERLO;CN;108;4;6;0;10
007048;PERLOZ;AO;458;7;6;0;13
028061;PERNUMIA;PD;3766;13;4;0;17
015170;PERO;MI;11477;13;9;0;22
001184;PEROSA ARGENTINA;TO;3094;9;8;0;17
001185;PEROSA CANAVESE;TO;525;11;2;0;13
001186;PERRERO;TO;583;9;4;0;13
019068;PERSICO DOSIMO;CR;3279;9;8;0;17
002091;PERTENGO;VC;305;6;5;0;11
017139;PERTICA ALTA;BS;557;7;5;0;12
017140;PERTICA BASSA;BS;576;8;5;0;13
065093;PERTOSA;SA;652;10;3;0;13
001187;PERTUSIO;TO;752;9;4;0;13
054039;PERUGIA;PG;162362;25;17;0;42
041044;PESARO;PU;95670;27;15;0;42
046022;PESCAGLIA;LU;3306;13;4;0;17
023058;PESCANTINA;VR;17426;13;8;0;21
068028;PESCARA;PE;118992;31;11;0;42
019069;PESCAROLO ED UNITI;CR;1516;6;6;0;12
066068;PESCASSEROLI;AQ;2076;10;3;0;13
097068;PESCATE;LC;2149;9;4;0;13
094031;PESCHE;IS;1517;5;6;0;11
071038;PESCHICI;FG;4305;11;6;0;17
015171;PESCHIERA BORROMEO;MI;24084;16;5;0;21
023059;PESCHIERA DEL GARDA;VR;10911;11;6;0;17
047012;PESCIA;PT;19223;17;4;0;21
066069;PESCINA;AQ;3762;15;2;0;17
062050;PESCO SANNITA;BN;1869;9;4;0;13
066070;PESCOCOSTANZO;AQ;1091;10;3;0;13
094032;PESCOLANCIANO;IS;810;13;0;0;13
076058;PESCOPAGANO;PZ;1702;10;3;0;13
094033;PESCOPENNATARO;IS;233;9;4;0;13
057049;PESCOROCCHIANO;RI;1928;8;5;0;13
068029;PESCOSANSONESCO;PE;471;11;2;0;13
060049;PESCOSOLIDO;FR;1462;9;4;0;13
015172;PESSANO CON BORNAGO;MI;8983;11;6;0;17
019070;PESSINA CREMONESE;CR;573;8;4;0;12
001188;PESSINETTO;TO;608;8;5;0;13
070051;PETACCIATO;CB;3494;10;6;0;16
065094;PETINA;SA;1037;12;1;0;13
082055;PETRALIA SOPRANA;PA;2992;10;7;0;17
082056;PETRALIA SOTTANA;PA;2492;9;6;0;15
057050;PETRELLA SALTO;RI;1036;11;2;0;13
070052;PETRELLA TIFERNINA;CB;1044;6;7;0;13
041045;PETRIANO;PU;2726;8;5;0;13
043036;PETRIOLO;MC;1843;10;2;0;12
079094;PETRIZZI;CZ;1028;9;4;0;13
079095;PETRONA';CZ;2404;7;5;0;12
081024;PETROSINO;TP;7962;8;9;0;17
064071;PETRURO IRPINO;AV;298;11;2;0;13
003116;PETTENASCO;NO;1341;8;5;0;13
096042;PETTINENGO;BI;1470;11;2;0;13
083067;PETTINEO;ME;1235;9;6;0;15
094034;PETTORANELLO DEL MOLISE;IS;449;10;3;0;13
066071;PETTORANO SUL GIZIO;AQ;1324;10;3;0;13
029035;PETTORAZZA GRIMANI;RO;1483;6;7;0;13
004163;PEVERAGNO;CN;5494;13;4;0;17
002093;PEZZANA;VC;1271;11;2;0;13
017141;PEZZAZE;BS;1448;11;2;0;13
004164;PEZZOLO VALLE UZZONE;CN;310;10;2;0;12
033032;PIACENZA;PC;102364;23;19;0;42
028062;PIACENZA D'ADIGE;PD;1231;8;5;0;13
019116;PIADENA DRIZZONA;CR;3967;12;5;0;17
065095;PIAGGINE;SA;1180;10;3;0;13
017142;PIAN CAMUNO;BS;4733;12;5;0;17
009048;PIANA CRIXIA;SV;760;10;3;0;13
082057;PIANA DEGLI ALBANESI;PA;5703;9;9;0;18
061056;PIANA DI MONTE VERNA;CE;2095;10;3;0;13
052020;PIANCASTAGNAIO;SI;3968;12;5;0;17
017206;PIANCOGNO;BS;4742;13;4;0;17
041047;PIANDIMELETO;PU;2061;9;4;0;13
078097;PIANE CRATI;CS;1378;10;3;0;13
068030;PIANELLA;PE;8524;12;5;0;17
013183;PIANELLO DEL LARIO;CO;1047;9;4;0;13
033033;PIANELLO VAL TIDONE;PC;2183;9;3;0;12
019072;PIANENGO;CR;2528;7;6;0;13
001189;PIANEZZA;TO;15449;13;9;0;22
024077;PIANEZZE;VI;2163;9;4;0;13
004165;PIANFEI;CN;2100;10;3;0;13
016162;PIANICO;BG;1436;9;4;0;13
027028;PIANIGA;VE;12237;12;10;0;22
063053;PIANO DI SORRENTO;NA;12486;12;10;0;22
079096;PIANOPOLI;CZ;2539;5;8;0;13
037047;PIANORO;BO;17586;13;8;0;21
056043;PIANSANO;VT;1886;8;5;0;13
014048;PIANTEDO;SO;1415;8;5;0;13
016163;PIARIO;BG;1006;9;4;0;13
004166;PIASCO;CN;2696;10;3;0;13
014049;PIATEDA;SO;2073;6;7;0;13
096043;PIATTO;BI;478;11;2;0;13
046023;PIAZZA AL SERCHIO;LU;2144;7;5;0;12
086014;PIAZZA ARMERINA;EN;20733;16;5;0;21
016164;PIAZZA BREMBANA;BG;1195;8;4;0;12
016165;PIAZZATORRE;BG;389;9;4;0;13
028063;PIAZZOLA SUL BRENTA;PD;11093;14;8;0;22
016166;PIAZZOLO;BG;87;7;5;0;12
068031;PICCIANO;PE;1287;12;1;0;13
076059;PICERNO;PZ;5664;11;6;0;17
060050;PICINISCO;FR;1130;10;3;0;13
060051;PICO;FR;2650;8;5;0;13
005084;PIEA;AT;522;9;3;0;12
096044;PIEDICAVALLO;BI;174;4;8;0;12
087035;PIEDIMONTE ETNEO;CT;3926;11;6;0;17
061057;PIEDIMONTE MATESE;CE;10308;14;8;0;22
060052;PIEDIMONTE SAN GERMANO;FR;6310;10;7;0;17
054040;PIEGARO;PG;3389;11;6;0;17
052021;PIENZA;SI;2007;11;2;0;13
019073;PIERANICA;CR;1120;7;6;0;13
018111;PIETRA DE' GIORGI;PV;755;9;4;0;13
009049;PIETRA LIGURE;SV;8326;9;8;0;17
006129;PIETRA MARAZZI;AL;867;11;2;0;13
094035;PIETRABBONDANTE;IS;635;12;1;0;13
008041;PIETRABRUNA;IM;453;9;4;0;13
067034;PIETRACAMELA;TE;222;9;4;0;13
070053;PIETRACATELLA;CB;1249;13;0;0;13
070054;PIETRACUPA;CB;207;10;3;0;13
064072;PIETRADEFUSI;AV;1965;8;5;0;13
069103;PIETRAFERRAZZANA;CH;130;10;3;0;13
078098;PIETRAFITTA;CS;1166;11;2;0;13
076060;PIETRAGALLA;PZ;3863;14;3;0;17
054041;PIETRALUNGA;PG;1990;9;4;0;13
061058;PIETRAMELARA;CE;4515;12;5;0;17
071039;PIETRAMONTECORVINO;FG;2511;10;3;0;13
068032;PIETRANICO;PE;435;9;4;0;13
078099;PIETRAPAOLA;CS;1021;9;4;0;13
076061;PIETRAPERTOSA;PZ;924;5;8;0;13
086015;PIETRAPERZIA;EN;6387;8;9;0;17
004167;PIETRAPORZIO;CN;73;9;4;0;13
062051;PIETRAROJA;BN;512;9;4;0;13
041048;PIETRARUBBIA;PU;602;9;3;0;12
046024;PIETRASANTA;LU;23066;16;6;0;22
064073;PIETRASTORNINA;AV;1455;10;3;0;13
061059;PIETRAVAIRANO;CE;2833;15;2;0;17
062052;PIETRELCINA;BN;2897;13;4;0;17
047013;PIEVE A NIEVOLE;PT;9120;9;8;0;17
018112;PIEVE ALBIGNOLA;PV;836;7;6;0;13
019074;PIEVE D'OLMI;CR;1233;7;6;0;13
018113;PIEVE DEL CAIRO;PV;1761;7;6;0;13
026096;PIEVE DEL GRAPPA;TV;6592;11;6;0;17
022234;PIEVE DI BONO-PREZZO;TN;1428;12;6;0;18
025039;PIEVE DI CADORE;BL;3681;7;9;0;16
037048;PIEVE DI CENTO;BO;7153;8;9;0;17
026057;PIEVE DI SOLIGO;TV;11680;14;7;0;21
008042;PIEVE DI TECO;IM;1322;10;3;0;13
015173;PIEVE EMANUELE;MI;15671;11;11;0;22
098045;PIEVE FISSIRAGA;LO;1757;10;3;0;13
046025;PIEVE FOSCIANA;LU;2263;10;3;0;13
010043;PIEVE LIGURE;GE;2429;5;8;0;13
018114;PIEVE PORTO MORONE;PV;2568;10;3;0;13
019075;PIEVE SAN GIACOMO;CR;1585;7;6;0;13
051030;PIEVE SANTO STEFANO;AR;2994;12;5;0;17
022142;PIEVE TESINO;TN;652;11;5;0;16
043038;PIEVE TORINA;MC;1268;9;4;0;13
036031;PIEVEPELAGO;MO;2142;8;5;0;13
060053;PIGLIO;FR;4382;13;4;0;17
008043;PIGNA;IM;763;12;1;0;13
060054;PIGNATARO INTERAMNA;FR;2447;10;3;0;13
061060;PIGNATARO MAGGIORE;CE;5761;8;9;0;17
076062;PIGNOLA;PZ;6783;10;7;0;17
011021;PIGNONE;SP;519;10;3;0;13
013184;PIGRA;CO;248;10;3;0;13
002096;PILA;VC;144;8;5;0;13
063054;PIMONTE;NA;5868;11;6;0;17
018115;PINAROLO PO;PV;1688;7;6;0;13
001190;PINASCA;TO;2853;8;8;0;16
029036;PINCARA;RO;1095;10;2;0;12
001191;PINEROLO;TO;35440;20;12;0;32
067035;PINETO;TE;14538;12;6;0;18
005085;PINO D'ASTI;AT;205;7;6;0;13
001192;PINO TORINESE;TO;8333;10;7;0;17
093030;PINZANO AL TAGLIAMENTO;PN;1498;8;7;0;15
022143;PINZOLO;TN;3061;19;5;0;24
041049;PIOBBICO;PU;1798;9;4;0;13
004168;PIOBESI D'ALBA;CN;1403;11;2;0;13
001193;PIOBESI TORINESE;TO;3818;10;7;0;17
002097;PIODE;VC;188;8;5;0;13
015175;PIOLTELLO;MI;36202;19;13;0;32
049012;PIOMBINO;LI;32304;19;13;0;32
028064;PIOMBINO DESE;PD;9480;9;8;0;17
043039;PIORACO;MC;992;8;5;0;13
001194;PIOSSASCO;TO;18087;13;9;0;22
005086;PIOVA' MASSAIA;AT;581;7;5;0;12
028065;PIOVE DI SACCO;PD;20138;12;10;0;22
024078;PIOVENE ROCCHETTE;VI;8160;10;6;0;16
033034;PIOZZANO;PC;580;7;6;0;13
004169;PIOZZO;CN;984;11;2;0;13
083068;PIRAINO;ME;3798;12;5;0;17
050026;PISA;PI;89002;26;16;0;42
003119;PISANO;NO;779;6;7;0;13
001195;PISCINA;TO;3319;9;8;0;17
065096;PISCIOTTA;SA;2447;9;4;0;13
017143;PISOGNE;BS;7803;10;7;0;17
058077;PISONIANO;RM;741;13;0;0;13
077020;PISTICCI;MT;16836;16;6;0;22
047014;PISTOIA;PT;89493;23;18;0;41
053019;PITIGLIANO;GR;3608;11;6;0;17
020041;PIUBEGA;MN;1711;9;4;0;13
014050;PIURO;SO;1901;8;5;0;13
001196;PIVERONE;TO;1302;6;7;0;13
018116;PIZZALE;PV;691;10;3;0;13
019076;PIZZIGHETTONE;CR;6273;11;6;0;17
069066;PIZZOFERRATO;CH;978;7;6;0;13
066072;PIZZOLI;AQ;4298;11;6;0;17
094036;PIZZONE;IS;315;11;2;0;13
080059;PLACANICA;RC;1043;6;4;0;10
078100;PLATACI;CS;675;7;6;0;13
079099;PLATANIA;CZ;1948;11;2;0;13
080060;PLATI';RC;3736;11;6;0;17
021064;PLAUS;BZ;740;10;6;0;16
013185;PLESIO;CO;817;9;4;0;13
090057;PLOAGHE;SS;4350;9;8;0;17
009050;PLODIO;SV;622;7;6;0;13
004170;POCAPAGLIA;CN;3287;14;3;0;17
030075;POCENIA;UD;2363;7;10;0;17
045013;PODENZANA;MS;2118;12;1;0;13
033035;PODENZANO;PC;9025;10;7;0;17
060055;POFI;FR;3972;13;4;0;17
075061;POGGIARDO;LE;5854;9;8;0;17
052022;POGGIBONSI;SI;28576;15;7;0;22
057051;POGGIO BUSTONE;RI;1975;11;2;0;13
057052;POGGIO CATINO;RI;1241;12;1;0;13
071040;POGGIO IMPERIALE;FG;2511;10;3;0;13
057053;POGGIO MIRTETO;RI;6145;9;8;0;17
057054;POGGIO MOIANO;RI;2818;9;4;0;13
057055;POGGIO NATIVO;RI;2569;9;4;0;13
066073;POGGIO PICENZE;AQ;1036;6;7;0;13
038018;POGGIO RENATICO;FE;9750;7;10;0;17
020042;POGGIO RUSCO;MN;6478;9;6;0;15
057056;POGGIO SAN LORENZO;RI;545;10;3;0;13
042037;POGGIO SAN MARCELLO;AN;654;10;3;0;13
043040;POGGIO SAN VICINO;MC;225;8;5;0;13
094037;POGGIO SANNITA;IS;584;10;3;0;13
099028;POGGIO TORRIANA;RN;5161;8;7;0;15
054042;POGGIODOMO;PG;99;9;4;0;13
069067;POGGIOFIORITO;CH;827;10;3;0;13
063055;POGGIOMARINO;NA;22011;15;7;0;22
072034;POGGIORSINI;BA;1291;8;5;0;13
014051;POGGIRIDENTI;SO;1819;7;6;0;13
015176;POGLIANO MILANESE;MI;8393;10;7;0;17
013186;POGNANA LARIO;CO;667;11;2;0;13
016167;POGNANO;BG;1560;8;5;0;13
003120;POGNO;NO;1350;8;5;0;13
001197;POIRINO;TO;10179;14;8;0;22
024079;POJANA MAGGIORE;VI;4271;13;4;0;17
017144;POLAVENO;BS;2464;8;5;0;13
093031;POLCENIGO;PN;3123;1;0;0;1
029037;POLESELLA;RO;3740;7;10;0;17
034050;POLESINE ZIBELLO;PR;3093;11;6;0;17
058078;POLI;RM;2260;7;6;0;13
077021;POLICORO;MT;17685;16;6;0;22
072035;POLIGNANO A MARE;BA;17680;13;9;0;22
036032;POLINAGO;MO;1582;8;3;0;11
055027;POLINO;TR;207;12;1;0;13
080061;POLISTENA;RC;9960;12;9;0;21
082058;POLIZZI GENEROSA;PA;2975;10;7;0;17
065097;POLLA;SA;5174;12;5;0;17
007049;POLLEIN;AO;1507;10;8;0;18
063056;POLLENA TROCCHIA;NA;12976;13;9;0;22
043041;POLLENZA;MC;6307;9;8;0;17
065098;POLLICA;SA;2178;10;3;0;13
082059;POLLINA;PA;2854;10;5;0;15
096046;POLLONE;BI;2033;11;2;0;13
069068;POLLUTRI;CH;2057;13;0;0;13
004171;POLONGHERA;CN;1112;10;3;0;13
017145;POLPENAZZE DEL GARDA;BS;2705;10;2;0;12
028066;POLVERARA;PD;3373;11;6;0;17
042038;POLVERIGI;AN;4601;11;6;0;17
050027;POMARANCE;PI;5390;7;10;0;17
001198;POMARETTO;TO;971;8;5;0;13
077022;POMARICO;MT;3832;12;5;0;17
006131;POMARO MONFERRATO;AL;313;9;4;0;13
022144;POMAROLO;TN;2456;12;8;0;20
003121;POMBIA;NO;2118;9;4;0;13
058079;POMEZIA;RM;64005;18;12;0;30
063057;POMIGLIANO D'ARCO;NA;39762;7;4;0;11
063058;POMPEI;NA;24098;17;5;0;22
008044;POMPEIANA;IM;852;9;4;0;13
017146;POMPIANO;BS;3744;9;8;0;17
020043;POMPONESCO;MN;1671;10;3;0;13
095042;POMPU;OR;215;8;3;0;11
017147;PONCARALE;BS;5161;12;5;0;17
096047;PONDERANO;BI;3740;12;4;0;16
013187;PONNA;CO;230;9;4;0;13
050028;PONSACCO;PI;15577;14;8;0;22
028067;PONSO;PD;2397;8;5;0;13
001199;PONT CANAVESE;TO;3087;0;0;1;1
007052;PONT-SAINT-MARTIN;AO;3553;13;8;0;21
048033;PONTASSIEVE;FI;20304;12;10;0;22
007050;PONTBOSET;AO;171;8;4;0;12
062053;PONTE;BN;2438;11;2;0;13
047016;PONTE BUGGIANESE;PT;8795;9;8;0;17
033036;PONTE DELL'OLIO;PC;4614;14;3;0;17
017148;PONTE DI LEGNO;BS;1747;10;3;0;13
026058;PONTE DI PIAVE;TV;8286;10;7;0;17
021065;PONTE GARDENA;BZ;202;10;5;0;15
014052;PONTE IN VALTELLINA;SO;2255;9;4;0;13
013188;PONTE LAMBRO;CO;4242;11;5;0;16
025040;PONTE NELLE ALPI;BL;7930;10;7;0;17
018117;PONTE NIZZA;PV;772;13;0;0;13
016168;PONTE NOSSA;BG;1719;4;7;0;11
028069;PONTE SAN NICOLO';PD;13307;13;9;0;22
016170;PONTE SAN PIETRO;BG;11481;12;10;0;22
030076;PONTEBBA;UD;1322;11;6;0;17
065099;PONTECAGNANO FAIANO;SA;25839;17;5;0;22
029038;PONTECCHIO POLESINE;RO;2214;10;3;0;13
004172;PONTECHIANALE;CN;187;11;2;0;13
060056;PONTECORVO;FR;12438;13;9;0;22
006132;PONTECURONE;AL;3427;9;6;0;15
008045;PONTEDASSIO;IM;2341;8;5;0;13
050029;PONTEDERA;PI;29284;12;10;0;22
062054;PONTELANDOLFO;BN;2021;10;3;0;13
061061;PONTELATONE;CE;1543;11;2;0;13
028068;PONTELONGO;PD;3641;7;10;0;17
033037;PONTENURE;PC;6511;11;6;0;17
016169;PONTERANICA;BG;6682;9;8;0;17
006133;PONTESTURA;AL;1312;10;3;0;13
017149;PONTEVICO;BS;6991;10;7;0;17
007051;PONTEY;AO;795;5;6;0;11
006134;PONTI;AL;544;8;5;0;13
020044;PONTI SUL MINCIO;MN;2275;7;5;0;12
016171;PONTIDA;BG;3276;12;4;0;16
059017;PONTINIA;LT;14913;14;8;0;22
009051;PONTINVREA;SV;820;8;4;0;12
016172;PONTIROLO NUOVO;BG;4946;11;6;0;17
017150;PONTOGLIO;BS;6902;10;7;0;17
045014;PONTREMOLI;MS;6931;10;7;0;17
059018;PONZA;LT;3305;11;6;0;17
006135;PONZANO MONFERRATO;AL;315;10;3;0;13
058080;PONZANO ROMANO;RM;1161;12;1;0;13
026059;PONZANO VENETO;TV;12981;14;8;0;22
006136;PONZONE;AL;999;10;3;0;13
068033;POPOLI;PE;4757;11;6;0;17
051031;POPPI;AR;5879;11;6;0;17
055028;PORANO;TR;1904;7;6;0;13
046026;PORCARI;LU;8789;10;7;0;17
093032;PORCIA;PN;14985;18;14;0;32
093033;PORDENONE;PN;51617;26;23;0;49
013189;PORLEZZA;CO;4820;8;9;0;17
008046;PORNASSIO;IM;656;8;5;0;13
030077;PORPETTO;UD;2475;9;8;0;17
005087;PORTACOMARO;AT;1926;9;4;0;13
018118;PORTALBERA;PV;1449;7;6;0;13
001200;PORTE;TO;1079;9;4;0;13
022244;PORTE DI RENDENA;TN;1782;14;5;0;19
063059;PORTICI;NA;52500;22;10;0;32
061062;PORTICO DI CASERTA;CE;7768;2;2;0;4
040031;PORTICO E SAN BENEDETTO;FC;735;9;4;0;13
080062;PORTIGLIOLA;RC;1091;0;0;3;3
049013;PORTO AZZURRO;LI;3640;12;5;0;17
012113;PORTO CERESIO;VA;2838;13;4;0;17
075097;PORTO CESAREO;LE;6300;9;8;0;17
084028;PORTO EMPEDOCLE;AG;15661;15;7;0;22
020045;PORTO MANTOVANO;MN;16498;16;6;0;22
043042;PORTO RECANATI;MC;12324;10;12;0;22
029039;PORTO TOLLE;RO;9135;8;9;0;17
090058;PORTO TORRES;SS;21330;19;8;0;27
012114;PORTO VALTRAVAGLIA;VA;2266;9;4;0;13
029052;PORTO VIRO;RO;13782;12;10;0;22
026060;PORTOBUFFOLE';TV;736;8;5;0;13
070055;PORTOCANNONE;CB;2339;10;3;0;13
049014;PORTOFERRAIO;LI;11864;12;10;0;22
010044;PORTOFINO;GE;369;9;4;0;13
027029;PORTOGRUARO;VE;24488;0;0;1;1
038019;PORTOMAGGIORE;FE;11584;15;7;0;22
089020;PORTOPALO DI CAPO PASSERO;SR;3798;12;5;0;17
011022;PORTOVENERE;SP;3310;11;6;0;17
096048;PORTULA;BI;1133;6;7;0;13
091073;POSADA;NU;3020;11;4;0;15
024080;POSINA;VI;558;11;1;0;12
065100;POSITANO;SA;3772;11;6;0;17
026061;POSSAGNO;TV;2224;8;5;0;13
057057;POSTA;RI;566;10;2;0;12
060057;POSTA FIBRENO;FR;1060;9;4;0;13
021066;POSTAL;BZ;1964;15;5;0;20
014053;POSTALESIO;SO;659;7;6;0;13
065101;POSTIGLIONE;SA;1998;12;1;0;13
002102;POSTUA;VC;561;8;5;0;13
076063;POTENZA;PZ;64850;28;14;0;42
043043;POTENZA PICENA;MC;15515;13;9;0;22
024081;POVE DEL GRAPPA;VI;3160;10;7;0;17
026062;POVEGLIANO;TV;5104;12;5;0;17
023060;POVEGLIANO VERONESE;VR;7330;7;10;0;17
035029;POVIGLIO;RE;7096;11;6;0;17
030078;POVOLETTO;UD;5410;15;8;0;23
057058;POZZAGLIA SABINA;RI;308;11;2;0;13
019077;POZZAGLIO ED UNITI;CR;1443;7;6;0;13
088008;POZZALLO;RG;18997;13;7;0;20
094038;POZZILLI;IS;2174;9;3;0;12
015177;POZZO D'ADDA;MI;6472;10;7;0;17
006137;POZZOL GROPPO;AL;296;12;1;0;13
017151;POZZOLENGO;BS;3556;12;4;0;16
024082;POZZOLEONE;VI;2773;10;3;0;13
006138;POZZOLO FORMIGARO;AL;4513;9;8;0;17
090059;POZZOMAGGIORE;SS;2416;11;6;0;17
028070;POZZONOVO;PD;3482;12;5;0;17
063060;POZZUOLI;NA;76952;25;8;0;33
030079;POZZUOLO DEL FRIULI;UD;6906;15;6;0;21
015178;POZZUOLO MARTESANA;MI;8543;10;7;0;17
016173;PRADALUNGA;BG;4518;12;5;0;17
030080;PRADAMANO;UD;3522;11;10;0;21
004173;PRADLEVES;CN;241;11;2;0;13
001201;PRAGELATO;TO;735;7;4;0;11
078101;PRAIA A MARE;CS;6418;8;5;0;13
065102;PRAIANO;SA;2009;7;4;0;11
017152;PRALBOINO;BS;2803;9;4;0;13
001202;PRALI;TO;249;8;3;0;11
001203;PRALORMO;TO;1899;9;4;0;13
096049;PRALUNGO;BI;2290;8;5;0;13
027030;PRAMAGGIORE;VE;4721;11;6;0;17
001204;PRAMOLLO;TO;222;8;5;0;13
002104;PRAROLO;VC;708;9;3;0;12
001205;PRAROSTINO;TO;1255;10;2;0;12
006139;PRASCO;AL;479;10;3;0;13
001206;PRASCORSANO;TO;726;8;5;0;13
014054;PRATA CAMPORTACCIO;SO;2918;8;5;0;13
066074;PRATA D'ANSIDONIA;AQ;453;9;4;0;13
093034;PRATA DI PORDENONE;PN;8350;10;12;0;22
064074;PRATA DI PRINCIPATO ULTRA;AV;2781;12;1;0;13
061063;PRATA SANNITA;CE;1394;11;0;0;11
061064;PRATELLA;CE;1457;10;3;0;13
001207;PRATIGLIONE;TO;458;8;5;0;13
021067;PRATO ALLO STELVIO;BZ;3734;20;4;0;24
030081;PRATO CARNICO;UD;853;9;4;0;13
003122;PRATO SESIA;NO;1849;7;6;0;13
066075;PRATOLA PELIGNA;AQ;7132;9;8;0;17
064075;PRATOLA SERRA;AV;3643;13;4;0;17
051041;PRATOVECCHIO STIA;AR;5439;11;6;0;17
093035;PRAVISDOMINI;PN;3410;12;10;0;22
096050;PRAY;BI;2008;7;6;0;13
004174;PRAZZO;CN;177;12;1;0;13
007053;PRE'-SAINT-DIDIER;AO;977;10;7;0;17
030082;PRECENICCO;UD;1433;8;8;0;16
054043;PRECI;PG;683;9;4;0;13
022230;PREDAIA;TN;6815;16;8;0;24
040032;PREDAPPIO;FC;6237;11;6;0;17
022147;PREDAZZO;TN;4502;17;6;0;23
021068;PREDOI;BZ;528;11;5;0;16
016174;PREDORE;BG;1846;8;5;0;13
006140;PREDOSA;AL;1895;8;4;0;12
026063;PREGANZIOL;TV;16799;14;8;0;22
015179;PREGNANA MILANESE;MI;7286;10;7;0;17
008047;PRELA';IM;482;10;3;0;13
097069;PREMANA;LC;2178;10;3;0;13
030083;PREMARIACCO;UD;3973;12;10;0;22
040033;PREMILCUORE;FC;708;10;3;0;13
016175;PREMOLO;BG;1061;11;2;0;13
030084;PREONE;UD;252;9;5;0;14
030085;PREPOTTO;UD;713;8;6;0;14
017153;PRESEGLIE;BS;1465;10;3;0;13
061065;PRESENZANO;CE;1658;10;3;0;13
016176;PRESEZZO;BG;4802;12;5;0;17
075098;PRESICCE-ACQUARICA;LE;9402;15;7;0;22
023061;PRESSANA;VR;2510;9;4;0;13
069069;PRETORO;CH;865;10;3;0;13
017155;PREVALLE;BS;6815;9;8;0;17
066076;PREZZA;AQ;886;10;3;0;13
004175;PRIERO;CN;525;8;5;0;13
065103;PRIGNANO CILENTO;SA;1070;11;2;0;13
036033;PRIGNANO SULLA SECCHIA;MO;3763;12;5;0;17
097070;PRIMALUNA;LC;2246;5;7;0;12
022245;PRIMIERO SAN MARTINO DI CASTROZZA;TN;5182;16;8;0;24
004176;PRIOCCA;CN;2025;9;4;0;13
004177;PRIOLA;CN;658;7;5;0;12
089021;PRIOLO GARGALLO;SR;11453;13;9;0;22
059019;PRIVERNO;LT;13792;13;9;0;22
082060;PRIZZI;PA;4264;10;7;0;17
056044;PROCENO;VT;528;8;5;0;13
063061;PROCIDA;NA;10160;11;11;0;22
010045;PROPATA;GE;113;7;6;0;13
013192;PROSERPIO;CO;940;7;6;0;13
059020;PROSSEDI;LT;1171;9;4;0;13
017156;PROVAGLIO D'ISEO;BS;7161;11;6;0;17
017157;PROVAGLIO VAL SABBIA;BS;884;8;3;0;11
021069;PROVES;BZ;258;13;3;0;16
070056;PROVVIDENTI;CB;107;10;3;0;13
004178;PRUNETTO;CN;409;12;0;0;12
017158;PUEGNAGO DEL GARDA;BS;3464;13;4;0;17
062055;PUGLIANELLO;BN;1304;10;3;0;13
092050;PULA;CA;7106;11;11;0;22
030086;PULFERO;UD;855;10;5;0;15
073022;PULSANO;TA;11204;13;9;0;22
016177;PUMENENGO;BG;1679;8;5;0;13
013193;PUSIANO;CO;1334;9;4;0;13
090060;PUTIFIGARI;SS;691;10;0;0;10
072036;PUTIGNANO;BA;26087;16;6;0;22
064076;QUADRELLE;AV;1802;11;2;0;13
069070;QUADRI;CH;717;9;4;0;13
001208;QUAGLIUZZO;TO;333;11;2;0;13
063062;QUALIANO;NA;24723;16;6;0;22
005088;QUARANTI;AT;150;11;2;0;13
096087;QUAREGNA CERRETO;BI;2031;9;4;0;13
006141;QUARGNENTO;AL;1347;7;6;0;13
002107;QUARONA;VC;3804;13;4;0;17
047017;QUARRATA;PT;26795;16;6;0;22
007054;QUART;AO;4089;14;8;0;22
063063;QUARTO;NA;41290;19;12;0;31
027031;QUARTO D'ALTINO;VE;8000;9;8;0;17
092051;QUARTU SANT'ELENA;CA;68853;23;14;0;37
092105;QUARTUCCIU;CA;12910;14;8;0;22
001209;QUASSOLO;TO;339;6;7;0;13
006142;QUATTORDIO;AL;1497;8;5;0;13
035030;QUATTRO CASTELLA;RE;13123;14;8;0;22
025070;QUERO VAS;BL;3116;12;5;0;17
009052;QUILIANO;SV;6902;10;7;0;17
001210;QUINCINETTO;TO;992;9;4;0;13
064077;QUINDICI;AV;1825;12;1;0;13
020046;QUINGENTOLE;MN;1058;10;3;0;13
019078;QUINTANO;CR;894;6;5;0;11
026064;QUINTO DI TREVISO;TV;9945;9;8;0;17
002108;QUINTO VERCELLESE;VC;391;7;6;0;13
024083;QUINTO VICENTINO;VI;5868;9;8;0;17
017159;QUINZANO D'OGLIO;BS;6177;7;9;0;16
020047;QUISTELLO;MN;5320;6;11;0;17
022150;RABBI;TN;1345;14;5;0;19
075063;RACALE;LE;10743;13;9;0;22
084029;RACALMUTO;AG;7645;8;9;0;17
004179;RACCONIGI;CN;9622;11;8;0;19
083069;RACCUJA;ME;889;8;7;0;15
021070;RACINES;BZ;4580;15;9;0;24
052023;RADDA IN CHIANTI;SI;1470;11;2;0;13
087036;RADDUSA;CT;2848;10;7;0;17
052024;RADICOFANI;SI;1065;10;3;0;13
052025;RADICONDOLI;SI;925;8;5;0;13
084030;RAFFADALI;AG;12184;13;9;0;22
087058;RAGALNA;CT;4184;10;7;0;17
030087;RAGOGNA;UD;2812;12;10;0;22
088009;RAGUSA;RG;72779;23;9;0;32
066077;RAIANO;AQ;2631;9;4;0;13
087037;RAMACCA;CT;10344;13;9;0;22
012115;RANCIO VALCUVIA;VA;906;11;2;0;13
012116;RANCO;VA;1251;10;0;0;10
087038;RANDAZZO;CT;10313;12;10;0;22
016178;RANICA;BG;5879;8;8;0;16
016179;RANZANICO;BG;1239;6;6;0;12
008048;RANZO;IM;558;9;3;0;12
010046;RAPALLO;GE;29107;15;7;0;22
069071;RAPINO;CH;1202;12;1;0;13
052026;RAPOLANO TERME;SI;5030;9;8;0;17
076064;RAPOLLA;PZ;4191;15;2;0;17
076065;RAPONE;PZ;885;7;6;0;13
002110;RASSA;VC;62;11;2;0;13
021071;RASUN ANTERSELVA;BZ;2911;17;3;0;20
014055;RASURA;SO;291;7;6;0;13
084031;RAVANUSA;AG;10500;14;8;0;22
036034;RAVARINO;MO;6214;9;8;0;17
030088;RAVASCLETTO;UD;494;10;4;0;14
065104;RAVELLO;SA;2395;11;2;0;13
039014;RAVENNA;RA;155836;29;13;0;42
030089;RAVEO;UD;444;10;4;0;14
061066;RAVISCANINA;CE;1184;12;1;0;13
018119;REA;PV;389;11;2;0;13
084032;REALMONTE;AG;4384;10;7;0;17
030090;REANA DEL ROJALE;UD;4737;11;10;0;21
001211;REANO;TO;1753;10;3;0;13
061067;RECALE;CE;7647;9;8;0;17
043044;RECANATI;MC;20697;16;6;0;22
010047;RECCO;GE;9464;13;9;0;22
003129;RECETTO;NO;956;9;4;0;13
024084;RECOARO TERME;VI;6076;10;7;0;17
018120;REDAVALLE;PV;1064;5;8;0;13
020048;REDONDESCO;MN;1214;9;4;0;13
005089;REFRANCORE;AT;1579;11;2;0;13
026065;REFRONTOLO;TV;1728;8;5;0;13
086016;REGALBUTO;EN;6743;8;9;0;17
048035;REGGELLO;FI;16529;12;10;0;22
080063;REGGIO DI CALABRIA;RC;172479;37;10;0;47
035033;REGGIO NELL'EMILIA;RE;169908;29;12;0;41
035032;REGGIOLO;RE;9123;9;8;0;17
062056;REINO;BN;1112;10;3;0;13
083070;REITANO;ME;733;7;7;0;14
030091;REMANZACCO;UD;6064;14;9;0;23
017160;REMEDELLO;BS;3346;10;7;0;17
078102;RENDE;CS;36123;0;0;3;3
021072;RENON;BZ;8062;19;5;0;24
026066;RESANA;TV;9380;11;6;0;17
015181;RESCALDINA;MI;14129;15;7;0;22
030092;RESIA;UD;933;7;10;0;17
030093;RESIUTTA;UD;259;9;5;0;14
085014;RESUTTANO;CL;1767;10;5;0;15
018121;RETORBIDO;PV;1530;9;4;0;13
004180;REVELLO;CN;4193;11;6;0;17
005090;REVIGLIASCO D'ASTI;AT;729;11;2;0;13
026067;REVINE LAGO;TV;2103;9;4;0;13
013195;REZZAGO;CO;308;8;0;0;8
017161;REZZATO;BS;13345;14;9;0;23
008049;REZZO;IM;312;10;2;0;12
010048;REZZOAGLIO;GE;875;8;5;0;13
007055;RHEMES-NOTRE-DAME;AO;81;6;5;0;11
007056;RHEMES-SAINT-GEORGES;AO;167;8;4;0;12
015182;RHO;MI;50618;23;9;0;32
080064;RIACE;RC;1813;7;6;0;13
009053;RIALTO;SV;546;10;3;0;13
058081;RIANO;RM;10271;12;5;0;17
061068;RIARDO;CE;2245;10;3;0;13
084033;RIBERA;AG;17986;14;8;0;22
001212;RIBORDONE;TO;49;10;3;0;13
006143;RICALDONE;AL;612;9;4;0;13
070057;RICCIA;CB;4901;10;7;0;17
099013;RICCIONE;RN;34603;0;0;2;2
011023;RICCO' DEL GOLFO DI SPEZIA;SP;3615;13;4;0;17
019079;RICENGO;CR;1738;10;3;0;13
065105;RICIGLIANO;SA;1073;10;3;0;13
026068;RIESE PIO X;TV;10901;14;8;0;22
085015;RIESI;CL;10631;14;8;0;22
057059;RIETI;RI;45557;26;16;0;42
021073;RIFIANO;BZ;1370;13;7;0;20
004181;RIFREDDO;CN;1050;7;5;0;12
058082;RIGNANO FLAMINIO;RM;10105;8;9;0;17
071041;RIGNANO GARGANICO;FG;1847;11;2;0;13
048036;RIGNANO SULL'ARNO;FI;8566;8;9;0;17
030094;RIGOLATO;UD;369;8;6;0;14
002113;RIMELLA;VC;133;11;2;0;13
099014;RIMINI;RN;149169;29;13;0;42
049021;RIO;LI;3315;12;5;0;17
021074;RIO DI PUSTERIA;BZ;3142;16;4;0;20
035034;RIO SALICETO;RE;6002;10;7;0;17
058083;RIOFREDDO;RM;739;12;1;0;13
095043;RIOLA SARDO;OR;2060;11;6;0;17
039015;RIOLO TERME;RA;5767;11;6;0;17
036035;RIOLUNATO;MO;662;9;4;0;13
011024;RIOMAGGIORE;SP;1353;10;3;0;13
076066;RIONERO IN VULTURE;PZ;12636;15;7;0;22
094039;RIONERO SANNITICO;IS;998;9;4;0;13
069072;RIPA TEATINA;CH;3981;11;6;0;17
070058;RIPABOTTONI;CB;456;11;2;0;13
076067;RIPACANDIDA;PZ;1594;12;1;0;13
070059;RIPALIMOSANI;CB;3036;7;6;0;13
019080;RIPALTA ARPINA;CR;1001;10;3;0;13
019081;RIPALTA CREMASCA;CR;3414;10;6;0;16
019082;RIPALTA GUERINA;CR;532;7;6;0;13
050030;RIPARBELLA;PI;1572;8;5;0;13
044063;RIPATRANSONE;AP;4042;9;8;0;17
043045;RIPE SAN GINESIO;MC;818;9;4;0;13
060058;RIPI;FR;5059;11;6;0;17
087039;RIPOSTO;CT;14078;11;11;0;22
004182;RITTANA;CN;109;9;4;0;13
022153;RIVA DEL GARDA;TN;17742;22;5;0;27
038029;RIVA DEL PO;FE;7511;8;9;0;17
016180;RIVA DI SOLTO;BG;881;6;7;0;13
008050;RIVA LIGURE;IM;2812;7;6;0;13
001215;RIVA PRESSO CHIERI;TO;4750;11;6;0;17
001213;RIVALBA;TO;1158;6;4;0;10
006144;RIVALTA BORMIDA;AL;1394;6;7;0;13
001214;RIVALTA DI TORINO;TO;20172;13;9;0;22
025043;RIVAMONTE AGORDINO;BL;627;9;4;0;13
018122;RIVANAZZANO TERME;PV;5139;9;8;0;17
001216;RIVARA;TO;2496;9;4;0;13
001217;RIVAROLO CANAVESE;TO;12280;13;8;0;21
019083;RIVAROLO DEL RE ED UNITI;CR;1824;9;4;0;13
020050;RIVAROLO MANTOVANO;MN;2415;9;4;0;13
006145;RIVARONE;AL;393;11;2;0;13
001218;RIVAROSSA;TO;1548;8;5;0;13
002115;RIVE;VC;424;9;4;0;13
030095;RIVE D'ARCANO;UD;2358;9;8;0;17
076068;RIVELLO;PZ;2542;8;5;0;13
033038;RIVERGARO;PC;7023;11;6;0;17
030188;RIVIGNANO TEOR;UD;6185;15;7;0;22
066078;RIVISONDOLI;AQ;674;10;3;0;13
057060;RIVODUTRI;RI;1150;9;4;0;13
001219;RIVOLI;TO;47481;22;9;0;31
023062;RIVOLI VERONESE;VR;2175;12;1;0;13
019084;RIVOLTA D'ADDA;CR;8137;8;9;0;17
080065;RIZZICONI;RC;7711;10;7;0;17
024085;ROANA;VI;4161;13;4;0;17
004183;ROASCHIA;CN;95;8;5;0;13
004184;ROASCIO;CN;91;9;4;0;13
002116;ROASIO;VC;2250;9;4;0;13
005091;ROATTO;AT;368;11;2;0;13
001220;ROBASSOMERO;TO;3052;10;2;0;12
097071;ROBBIATE;LC;6262;11;6;0;17
018123;ROBBIO;PV;5767;10;7;0;17
015183;ROBECCHETTO CON INDUNO;MI;4767;10;7;0;17
019085;ROBECCO D'OGLIO;CR;2249;8;5;0;13
018124;ROBECCO PAVESE;PV;518;10;3;0;13
015184;ROBECCO SUL NAVIGLIO;MI;6745;11;6;0;17
005092;ROBELLA;AT;437;10;3;0;13
004185;ROBILANTE;CN;2147;8;5;0;13
004186;ROBURENT;CN;476;0;0;1;1
001221;ROCCA CANAVESE;TO;1667;9;4;0;13
058084;ROCCA CANTERANO;RM;182;10;3;0;13
004188;ROCCA CIGLIE';CN;125;9;4;0;13
005093;ROCCA D'ARAZZO;AT;909;5;8;0;13
060059;ROCCA D'ARCE;FR;911;10;3;0;13
061069;ROCCA D'EVANDRO;CE;3042;12;5;0;17
004189;ROCCA DE' BALDI;CN;1565;11;2;0;13
018125;ROCCA DE' GIORGI;PV;60;9;4;0;13
066080;ROCCA DI BOTTE;AQ;856;8;5;0;13
066081;ROCCA DI CAMBIO;AQ;490;10;3;0;13
058085;ROCCA DI CAVE;RM;349;9;4;0;13
066082;ROCCA DI MEZZO;AQ;1348;12;1;0;13
058086;ROCCA DI PAPA;RM;17390;0;0;1;1
006147;ROCCA GRIMALDA;AL;1430;9;4;0;13
078103;ROCCA IMPERIALE;CS;3226;12;5;0;17
059022;ROCCA MASSIMA;LT;1080;10;3;0;13
066083;ROCCA PIA;AQ;178;11;2;0;13
025044;ROCCA PIETORE;BL;1146;11;2;0;13
058088;ROCCA PRIORA;RM;12076;14;8;0;22
040036;ROCCA SAN CASCIANO;FC;1791;9;4;0;13
064079;ROCCA SAN FELICE;AV;797;12;1;0;13
069074;ROCCA SAN GIOVANNI;CH;2281;8;5;0;13
067036;ROCCA SANTA MARIA;TE;477;10;3;0;13
058089;ROCCA SANTO STEFANO;RM;934;9;4;0;13
057062;ROCCA SINIBALDA;RI;790;10;3;0;13
018126;ROCCA SUSELLA;PV;228;9;4;0;13
064078;ROCCABASCERANA;AV;2319;10;3;0;13
034030;ROCCABIANCA;PR;2887;10;7;0;17
004187;ROCCABRUNA;CN;1531;10;3;0;13
066079;ROCCACASALE;AQ;598;9;4;0;13
065106;ROCCADASPIDE;SA;6971;11;6;0;17
083071;ROCCAFIORITA;ME;182;11;4;0;15
044064;ROCCAFLUVIONE;AP;1903;10;3;0;13
080066;ROCCAFORTE DEL GRECO;RC;367;9;4;0;13
006146;ROCCAFORTE LIGURE;AL;123;11;2;0;13
004190;ROCCAFORTE MONDOVI';CN;2056;7;4;0;11
073023;ROCCAFORZATA;TA;1800;8;5;1;14
017162;ROCCAFRANCA;BS;4835;9;8;0;17
058087;ROCCAGIOVINE;RM;259;10;3;0;13
065107;ROCCAGLORIOSA;SA;1563;12;1;0;13
059021;ROCCAGORGA;LT;4202;0;0;1;1
053020;ROCCALBEGNA;GR;923;6;5;0;11
083072;ROCCALUMERA;ME;3914;7;10;0;17
094040;ROCCAMANDOLFI;IS;857;8;5;0;13
082061;ROCCAMENA;PA;1394;8;7;0;15
061070;ROCCAMONFINA;CE;3206;11;6;0;17
069073;ROCCAMONTEPIANO;CH;1572;10;3;0;13
068034;ROCCAMORICE;PE;894;11;2;0;13
076069;ROCCANOVA;PZ;1313;8;5;0;13
057061;ROCCANTICA;RI;548;7;3;0;10
082062;ROCCAPALUMBA;PA;2264;9;6;0;15
065108;ROCCAPIEMONTE;SA;8718;7;9;0;16
063065;ROCCARAINOLA;NA;6623;10;7;0;17
066084;ROCCARASO;AQ;1507;8;5;0;13
061071;ROCCAROMANA;CE;839;9;2;0;11
069075;ROCCASCALEGNA;CH;1057;10;3;0;13
060060;ROCCASECCA;FR;6975;10;7;0;17
059023;ROCCASECCA DEI VOLSCI;LT;1050;7;4;0;11
094041;ROCCASICURA;IS;492;9;3;0;12
004191;ROCCASPARVERA;CN;743;11;2;0;13
069076;ROCCASPINALVETI;CH;1195;10;3;0;13
053021;ROCCASTRADA;GR;8761;11;6;0;17
083073;ROCCAVALDINA;ME;1006;9;6;0;15
005094;ROCCAVERANO;AT;368;12;1;0;13
009054;ROCCAVIGNALE;SV;741;8;4;0;12
004192;ROCCAVIONE;CN;2636;7;5;0;12
070060;ROCCAVIVARA;CB;641;12;1;0;13
080067;ROCCELLA IONICA;RC;6180;9;8;0;17
083074;ROCCELLA VALDEMONE;ME;567;11;5;0;16
094042;ROCCHETTA A VOLTURNO;IS;1074;11;2;0;13
004193;ROCCHETTA BELBO;CN;155;10;3;0;13
011025;ROCCHETTA DI VARA;SP;674;12;1;0;13
061072;ROCCHETTA E CROCE;CE;451;12;1;0;13
006148;ROCCHETTA LIGURE;AL;218;8;3;0;11
008051;ROCCHETTA NERVINA;IM;293;9;1;0;10
005095;ROCCHETTA PALAFEA;AT;342;8;5;0;13
071042;ROCCHETTA SANT'ANTONIO;FG;1683;9;4;0;13
005096;ROCCHETTA TANARO;AT;1367;9;2;0;11
015185;RODANO;MI;4627;10;7;0;17
004194;RODDI;CN;1572;9;4;0;13
004195;RODDINO;CN;409;7;6;0;13
004196;RODELLO;CN;963;9;4;0;13
017163;RODENGO SAIANO;BS;9797;11;6;0;17
021075;RODENGO;BZ;1253;15;5;0;20
013197;RODERO;CO;1259;9;4;0;13
071043;RODI GARGANICO;FG;3350;12;5;0;17
083075;RODI' MILICI;ME;1947;11;4;0;15
020051;RODIGO;MN;5153;10;7;0;17
017164;ROE' VOLCIANO;BS;4366;12;5;0;17
065109;ROFRANO;SA;1293;11;2;0;13
097072;ROGENO;LC;3058;11;6;0;17
078104;ROGGIANO GRAVINA;CS;6820;9;8;0;17
080068;ROGHUDI;RC;971;8;4;0;12
078105;ROGLIANO;CS;5399;11;6;0;17
018127;ROGNANO;PV;660;9;4;0;13
016182;ROGNO;BG;3874;9;8;0;17
014056;ROGOLO;SO;561;9;4;0;13
058090;ROIATE;RM;649;10;3;0;13
069077;ROIO DEL SANGRO;CH;98;10;3;0;13
007057;ROISAN;AO;1005;10;8;0;18
001222;ROLETTO;TO;1988;10;3;0;13
035035;ROLO;RE;4016;10;7;0;17
058091;ROMA;RM;2749031;36;25;0;61
065110;ROMAGNANO AL MONTE;SA;375;10;2;0;12
003130;ROMAGNANO SESIA;NO;3677;12;5;0;17
018128;ROMAGNESE;PV;580;10;3;0;13
090061;ROMANA;SS;497;9;5;0;14
019086;ROMANENGO;CR;3190;13;3;0;16
001223;ROMANO CANAVESE;TO;2642;9;4;0;13
024086;ROMANO D'EZZELINO;VI;14150;14;8;0;22
016183;ROMANO DI LOMBARDIA;BG;20613;17;5;0;22
031015;ROMANS D'ISONZO;GO;3636;14;8;0;22
022155;ROMENO;TN;1397;13;7;0;20
003131;ROMENTINO;NO;5625;8;8;0;16
083076;ROMETTA;ME;6529;10;7;0;17
013199;RONAGO;CO;1630;12;1;0;13
023063;RONCA';VR;3752;11;6;0;17
026069;RONCADE;TV;14680;13;9;0;22
017165;RONCADELLE;BS;9282;8;9;0;17
018129;RONCARO;PV;1555;7;5;0;12
022156;RONCEGNO TERME;TN;2914;14;6;0;20
031016;RONCHI DEI LEGIONARI;GO;11807;17;10;0;27
022157;RONCHI VALSUGANA;TN;454;9;6;0;15
030097;RONCHIS;UD;1942;9;4;0;13
056045;RONCIGLIONE;VT;8417;10;7;0;17
023064;RONCO ALL'ADIGE;VR;5946;9;8;0;17
096053;RONCO BIELLESE;BI;1432;10;3;0;13
001224;RONCO CANAVESE;TO;293;8;5;0;13
010049;RONCO SCRIVIA;GE;4179;9;8;0;17
016184;RONCOBELLO;BG;420;7;6;0;13
020052;RONCOFERRARO;MN;6802;12;5;0;17
040037;RONCOFREDDO;FC;3379;9;7;0;16
016185;RONCOLA;BG;869;9;4;0;13
010050;RONDANINA;GE;60;10;3;0;13
001225;RONDISSONE;TO;1849;11;2;0;13
002118;RONSECCO;VC;543;10;3;0;13
022135;RONZO-CHIENIS;TN;992;10;8;0;18
022159;RONZONE;TN;459;10;3;0;13
096054;ROPPOLO;BI;861;7;3;0;10
001226;RORA';TO;227;11;2;0;13
024087;ROSA';VI;14649;14;8;0;22
080069;ROSARNO;RC;14639;0;0;3;3
018130;ROSASCO;PV;546;11;2;0;13
015188;ROSATE;MI;5758;10;7;0;17
096055;ROSAZZA;BI;104;4;6;0;10
068035;ROSCIANO;PE;4038;12;5;0;17
065111;ROSCIGNO;SA;662;7;6;0;13
078106;ROSE;CS;4164;12;5;0;17
069078;ROSELLO;CH;186;9;4;0;13
078107;ROSETO CAPO SPULICO;CS;1859;8;5;0;13
067037;ROSETO DEGLI ABRUZZI;TE;25473;13;9;0;22
071044;ROSETO VALFORTORE;FG;986;10;3;0;13
049017;ROSIGNANO MARITTIMO;LI;30072;20;11;0;31
006149;ROSIGNANO MONFERRATO;AL;1458;10;3;0;13
029040;ROSOLINA;RO;6221;10;7;0;17
089016;ROSOLINI;SR;20639;17;5;0;22
042040;ROSORA;AN;1858;8;5;0;13
002121;ROSSA;VC;175;9;4;0;13
004197;ROSSANA;CN;820;9;4;0;13
024088;ROSSANO VENETO;VI;8183;11;6;0;17
010051;ROSSIGLIONE;GE;2560;8;5;0;13
001228;ROSTA;TO;5056;8;9;0;17
016186;ROTA D'IMAGNA;BG;895;6;7;0;13
078109;ROTA GRECA;CS;1011;12;1;0;13
044065;ROTELLA;AP;815;11;2;0;13
070061;ROTELLO;CB;1122;6;7;0;13
076070;ROTONDA;PZ;3225;10;7;0;17
077023;ROTONDELLA;MT;2448;10;3;0;13
064080;ROTONDI;AV;3424;14;3;0;17
033039;ROTTOFRENO;PC;12200;13;9;0;22
024089;ROTZO;VI;641;8;5;0;13
001227;ROURE;TO;765;10;3;0;13
002122;ROVASENDA;VC;912;10;3;0;13
017166;ROVATO;BS;19198;13;9;0;22
010052;ROVEGNO;GE;492;11;2;0;13
013201;ROVELLASCA;CO;7923;9;8;0;17
013202;ROVELLO PORRO;CO;6209;9;8;0;17
020053;ROVERBELLA;MN;8670;9;8;0;17
023065;ROVERCHIARA;VR;2582;10;3;0;13
022160;ROVERE' DELLA LUNA;TN;1638;10;9;0;19
023067;ROVERE' VERONESE;VR;2094;12;1;0;13
023066;ROVEREDO DI GUA';VR;1618;9;4;0;13
093036;ROVEREDO IN PIANO;PN;5860;14;8;0;22
022161;ROVERETO;TN;39766;30;10;0;40
018131;ROVESCALA;PV;845;8;5;0;13
016187;ROVETTA;BG;4110;12;5;0;17
058092;ROVIANO;RM;1256;9;4;0;13
029041;ROVIGO;RO;50190;27;14;0;41
078110;ROVITO;CS;3025;8;5;0;13
028071;ROVOLON;PD;4878;11;6;0;17
015189;ROZZANO;MI;41435;17;14;0;31
028072;RUBANO;PD;16794;13;9;0;22
001229;RUBIANA;TO;2391;7;6;0;13
035036;RUBIERA;RE;14765;12;9;0;21
030098;RUDA;UD;2790;9;8;0;17
017167;RUDIANO;BS;5857;9;8;0;17
001230;RUEGLIO;TO;788;10;3;0;13
075064;RUFFANO;LE;9353;11;6;0;17
004198;RUFFIA;CN;364;12;1;0;13
022162;RUFFRE'-MENDOLA;TN;427;8;6;0;14
048037;RUFINA;FI;7118;10;7;0;17
095044;RUINAS;OR;621;9;5;0;14
022163;RUMO;TN;798;9;7;0;16
076071;RUOTI;PZ;3345;14;3;0;17
039016;RUSSI;RA;12107;11;11;0;22
072037;RUTIGLIANO;BA;18262;14;8;0;22
065112;RUTINO;SA;765;8;5;0;13
061073;RUVIANO;CE;1716;11;2;0;13
076072;RUVO DEL MONTE;PZ;1001;9;4;0;13
072038;RUVO DI PUGLIA;BA;24520;13;8;0;21
059024;SABAUDIA;LT;19666;16;6;0;22
017168;SABBIO CHIESE;BS;3932;10;7;0;17
020054;SABBIONETA;MN;4100;12;5;0;17
065113;SACCO;SA;443;9;4;0;13
028073;SACCOLONGO;PD;4900;12;5;0;17
093037;SACILE;PN;19877;17;15;0;32
058093;SACROFANO;RM;7403;9;8;0;17
095086;SAGAMA;OR;195;9;5;0;14
096056;SAGLIANO MICCA;BI;1540;10;2;0;12
031017;SAGRADO;GO;2168;9;8;0;17
022164;SAGRON MIS;TN;178;11;5;0;16
007058;SAINT-CHRISTOPHE;AO;3484;14;7;0;21
007059;SAINT-DENIS;AO;371;7;6;0;13
007060;SAINT-MARCEL;AO;1312;13;6;0;19
007061;SAINT-NICOLAS;AO;321;6;7;0;13
007062;SAINT-OYEN;AO;198;6;8;0;14
007063;SAINT-PIERRE;AO;3240;13;7;0;20
007064;SAINT-RHEMY-EN-BOSSES;AO;330;10;4;0;14
007065;SAINT-VINCENT;AO;4451;13;8;0;21
034031;SALA BAGANZA;PR;5802;9;8;0;17
096057;SALA BIELLESE;BI;571;9;4;0;13
037050;SALA BOLOGNESE;BO;8462;8;8;0;16
013203;SALA COMACINA;CO;481;13;0;0;13
065114;SALA CONSILINA;SA;12258;14;8;0;22
006150;SALA MONFERRATO;AL;340;8;5;0;13
077024;SALANDRA;MT;2575;13;0;0;13
081017;SALAPARUTA;TP;1595;10;5;0;15
029042;SALARA;RO;1053;8;5;0;13
002126;SALASCO;VC;207;6;6;0;12
001231;SALASSA;TO;1792;10;3;0;13
001232;SALBERTRAND;TO;605;9;4;0;13
024090;SALCEDO;VI;1024;11;2;0;13
070062;SALCITO;CB;631;8;4;0;12
006151;SALE;AL;3916;13;4;0;17
004199;SALE DELLE LANGHE;CN;472;13;0;0;13
017169;SALE MARASINO;BS;3290;12;5;0;17
004200;SALE SAN GIOVANNI;CN;154;8;5;0;13
081018;SALEMI;TP;10082;14;7;0;21
065115;SALENTO;SA;1802;10;3;0;13
001233;SALERANO CANAVESE;TO;458;10;3;0;13
098046;SALERANO SUL LAMBRO;LO;2602;5;6;0;11
065116;SALERNO;SA;128136;31;11;0;42
026070;SALGAREDA;TV;6567;9;8;0;17
002127;SALI VERCELLESE;VC;99;7;6;0;13
075065;SALICE SALENTINO;LE;7838;11;6;0;17
004201;SALICETO;CN;1184;10;2;0;12
057063;SALISANO;RI;498;10;3;0;13
023068;SALIZZOLE;VR;3759;11;6;0;17
068036;SALLE;PE;270;11;2;0;13
004202;SALMOUR;CN;716;10;3;0;13
017170;SALO';BS;10448;11;7;0;18
021076;SALORNO SULLA STRADA DEL VINO;BZ;3768;16;7;0;23
034032;SALSOMAGGIORE TERME;PR;19906;10;12;0;22
012117;SALTRIO;VA;2987;10;7;0;17
099015;SALUDECIO;RN;3048;12;5;0;17
002128;SALUGGIA;VC;3777;11;6;0;17
096058;SALUSSOLA;BI;1868;8;5;0;13
004203;SALUZZO;CN;17433;17;5;0;22
075066;SALVE;LE;4485;11;6;0;17
019087;SALVIROLA;CR;1162;8;5;0;13
065117;SALVITELLE;SA;496;11;2;0;13
001234;SALZA DI PINEROLO;TO;74;12;1;0;13
064081;SALZA IRPINA;AV;723;10;3;0;13
027032;SALZANO;VE;12802;13;9;0;22
012118;SAMARATE;VA;16037;14;8;0;22
084034;SAMBUCA DI SICILIA;AG;5418;10;8;0;18
047018;SAMBUCA PISTOIESE;PT;1446;11;3;0;14
058094;SAMBUCI;RM;839;0;0;1;1
004204;SAMBUCO;CN;86;10;3;0;13
072039;SAMMICHELE DI BARI;BA;6074;9;8;0;17
080070;SAMO;RC;737;13;0;0;13
014057;SAMOLACO;SO;2886;10;3;0;13
001235;SAMONE;TO;1468;5;8;0;13
022165;SAMONE;TN;544;9;6;0;15
004205;SAMPEYRE;CN;988;11;2;0;13
095045;SAMUGHEO;OR;2796;11;6;0;17
008052;SAN BARTOLOMEO AL MARE;IM;2943;13;4;0;17
062057;SAN BARTOLOMEO IN GALDO;BN;4417;10;7;0;17
013204;SAN BARTOLOMEO VAL CAVARGNA;CO;967;6;7;0;13
078111;SAN BASILE;CS;954;11;2;0;13
019088;SAN BASSANO;CR;2105;7;5;0;12
029043;SAN BELLINO;RO;1035;6;7;0;13
004206;SAN BENEDETTO BELBO;CN;151;12;1;0;13
066085;SAN BENEDETTO DEI MARSI;AQ;3746;13;4;0;17
044066;SAN BENEDETTO DEL TRONTO;AP;47000;19;13;0;32
066086;SAN BENEDETTO IN PERILLIS;AQ;98;5;8;0;13
020055;SAN BENEDETTO PO;MN;6716;10;7;0;17
078112;SAN BENEDETTO ULLANO;CS;1390;8;5;0;13
037051;SAN BENEDETTO VAL DI SAMBRO;BO;4202;12;5;0;17
001236;SAN BENIGNO CANAVESE;TO;5999;9;8;0;17
008053;SAN BIAGIO DELLA CIMA;IM;1246;10;3;0;13
026071;SAN BIAGIO DI CALLALTA;TV;12761;12;10;0;22
084035;SAN BIAGIO PLATANI;AG;2919;10;7;0;17
060061;SAN BIAGIO SARACINISCO;FR;313;11;2;0;13
070063;SAN BIASE;CB;134;9;4;0;13
023069;SAN BONIFACIO;VR;21354;13;9;0;22
069079;SAN BUONO;CH;869;9;4;0;13
021077;SAN CANDIDO;BZ;3405;20;4;0;24
031018;SAN CANZIAN D'ISONZO;GO;6040;11;6;0;17
001237;SAN CARLO CANAVESE;TO;4010;10;7;0;17
052027;SAN CASCIANO DEI BAGNI;SI;1516;7;6;0;13
048038;SAN CASCIANO IN VAL DI PESA;FI;16643;10;12;0;22
075095;SAN CASSIANO;LE;1963;11;2;0;13
085016;SAN CATALDO;CL;21212;18;4;0;22
058119;SAN CESAREO;RM;15960;15;7;0;22
075068;SAN CESARIO DI LECCE;LE;7912;9;4;0;13
036036;SAN CESARIO SUL PANARO;MO;6574;10;7;0;17
076073;SAN CHIRICO NUOVO;PZ;1206;10;3;0;13
076074;SAN CHIRICO RAPARO;PZ;953;9;3;0;12
082063;SAN CIPIRELLO;PA;4998;12;6;0;18
061074;SAN CIPRIANO D'AVERSA;CE;13130;13;9;0;22
065118;SAN CIPRIANO PICENTINO;SA;6516;9;8;0;17
018133;SAN CIPRIANO PO;PV;465;9;4;0;13
099016;SAN CLEMENTE;RN;5671;8;9;0;17
015191;SAN COLOMBANO AL LAMBRO;MI;7239;11;6;0;17
001238;SAN COLOMBANO BELMONTE;TO;358;12;1;0;13
010053;SAN COLOMBANO CERTENOLI;GE;2563;9;4;0;13
087040;SAN CONO;CT;2440;9;6;0;15
078113;SAN COSMO ALBANESE;CS;578;10;3;0;13
076075;SAN COSTANTINO ALBANESE;PZ;624;12;1;0;13
041051;SAN COSTANZO;PU;4554;10;7;0;17
006152;SAN CRISTOFORO;AL;542;7;6;0;13
018134;SAN DAMIANO AL COLLE;PV;629;6;7;0;13
005097;SAN DAMIANO D'ASTI;AT;8075;9;10;0;19
004207;SAN DAMIANO MACRA;CN;414;8;5;0;13
030099;SAN DANIELE DEL FRIULI;UD;7914;16;6;0;22
019089;SAN DANIELE PO;CR;1291;7;6;0;13
078114;SAN DEMETRIO CORONE;CS;3122;15;2;0;17
066087;SAN DEMETRIO NE' VESTINI;AQ;1902;9;4;0;13
001239;SAN DIDERO;TO;516;7;6;0;13
027033;SAN DONA' DI PIAVE;VE;41664;21;10;0;31
074013;SAN DONACI;BR;6216;10;7;0;17
075069;SAN DONATO DI LECCE;LE;5484;11;6;0;17
078115;SAN DONATO DI NINEA;CS;1131;10;3;0;13
015192;SAN DONATO MILANESE;MI;32008;21;11;0;32
060062;SAN DONATO VAL DI COMINO;FR;1897;9;4;0;13
032004;SAN DORLIGO DELLA VALLE-DOLINA;TS;5693;12;10;0;22
076076;SAN FELE;PZ;2655;13;4;0;17
061075;SAN FELICE A CANCELLO;CE;16963;15;7;0;22
059025;SAN FELICE CIRCEO;LT;10100;9;8;0;17
017171;SAN FELICE DEL BENACO;BS;3465;10;7;0;17
070064;SAN FELICE DEL MOLISE;CB;560;11;2;0;13
036037;SAN FELICE SUL PANARO;MO;10679;13;9;0;22
080097;SAN FERDINANDO;RC;4488;16;1;0;17
013206;SAN FERMO DELLA BATTAGLIA;CO;7799;10;7;0;17
078116;SAN FILI;CS;2531;12;1;0;13
083077;SAN FILIPPO DEL MELA;ME;6791;11;7;0;18
026072;SAN FIOR;TV;6843;11;6;0;17
098047;SAN FIORANO;LO;1851;8;5;0;13
031019;SAN FLORIANO DEL COLLIO;GO;742;6;7;0;13
079108;SAN FLORO;CZ;689;9;4;0;13
001240;SAN FRANCESCO AL CAMPO;TO;4847;13;4;0;17
083078;SAN FRATELLO;ME;3323;8;9;0;17
055029;SAN GEMINI;TR;4769;14;3;0;17
021079;SAN GENESIO ATESINO;BZ;3048;14;6;0;20
018135;SAN GENESIO ED UNITI;PV;4010;8;9;0;17
063066;SAN GENNARO VESUVIANO;NA;12031;10;7;0;17
001242;SAN GERMANO CHISONE;TO;1691;8;5;0;13
002131;SAN GERMANO VERCELLESE;VC;1473;9;4;0;13
017172;SAN GERVASIO BRESCIANO;BS;2685;10;3;0;13
070065;SAN GIACOMO DEGLI SCHIAVONI;CB;1392;11;2;0;13
020056;SAN GIACOMO DELLE SEGNATE;MN;1462;8;5;0;13
014058;SAN GIACOMO FILIPPO;SO;369;11;2;0;13
002035;SAN GIACOMO VERCELLESE;VC;277;10;2;0;12
001243;SAN GILLIO;TO;3217;9;8;0;17
052028;SAN GIMIGNANO;SI;7487;9;8;0;17
043046;SAN GINESIO;MC;3114;4;0;0;4
063067;SAN GIORGIO A CREMANO;NA;43057;21;11;0;32
060063;SAN GIORGIO A LIRI;FR;3043;15;2;0;17
078118;SAN GIORGIO ALBANESE;CS;1336;11;2;0;13
020057;SAN GIORGIO BIGARELLO;MN;11812;13;9;0;22
001244;SAN GIORGIO CANAVESE;TO;2534;10;2;0;12
062058;SAN GIORGIO DEL SANNIO;BN;9815;10;7;0;17
093038;SAN GIORGIO DELLA RICHINVELDA;PN;4531;12;10;0;22
028075;SAN GIORGIO DELLE PERTICHE;PD;10130;10;7;0;17
018136;SAN GIORGIO DI LOMELLINA;PV;1013;10;3;0;13
030100;SAN GIORGIO DI NOGARO;UD;7280;10;13;0;23
037052;SAN GIORGIO DI PIANO;BO;9163;9;8;0;17
028076;SAN GIORGIO IN BOSCO;PD;6389;9;8;0;17
073024;SAN GIORGIO IONICO;TA;14355;14;8;0;22
062059;SAN GIORGIO LA MOLARA;BN;2821;15;2;0;17
077025;SAN GIORGIO LUCANO;MT;1078;10;3;0;13
006153;SAN GIORGIO MONFERRATO;AL;1201;12;1;0;13
080071;SAN GIORGIO MORGETO;RC;2965;13;4;0;17
033040;SAN GIORGIO PIACENTINO;PC;5605;9;6;0;15
005098;SAN GIORGIO SCARAMPI;AT;97;11;2;0;13
015194;SAN GIORGIO SU LEGNANO;MI;6697;10;7;0;17
001245;SAN GIORIO DI SUSA;TO;987;6;6;0;12
065119;SAN GIOVANNI A PIRO;SA;3648;13;4;0;17
030101;SAN GIOVANNI AL NATISONE;UD;6052;15;7;0;22
016188;SAN GIOVANNI BIANCO;BG;4625;11;6;0;17
020058;SAN GIOVANNI DEL DOSSO;MN;1245;8;5;0;13
022250;SAN GIOVANNI DI FASSA;TN;3576;15;8;0;23
080072;SAN GIOVANNI DI GERACE;RC;419;9;4;0;13
084036;SAN GIOVANNI GEMINI;AG;7604;11;7;0;18
023070;SAN GIOVANNI ILARIONE;VR;4898;10;6;0;16
019090;SAN GIOVANNI IN CROCE;CR;1889;7;5;0;12
078119;SAN GIOVANNI IN FIORE;CS;16106;17;9;0;26
070066;SAN GIOVANNI IN GALDO;CB;537;8;5;0;13
099017;SAN GIOVANNI IN MARIGNANO;RN;9451;8;9;0;17
037053;SAN GIOVANNI IN PERSICETO;BO;27869;12;10;0;22
060064;SAN GIOVANNI INCARICO;FR;3094;13;4;0;17
087041;SAN GIOVANNI LA PUNTA;CT;23649;18;2;0;20
069080;SAN GIOVANNI LIPIONI;CH;139;10;3;0;13
023071;SAN GIOVANNI LUPATOTO;VR;25334;15;7;0;22
071046;SAN GIOVANNI ROTONDO;FG;26382;16;6;0;22
069081;SAN GIOVANNI TEATINO;CH;14258;10;12;0;22
051033;SAN GIOVANNI VALDARNO;AR;16644;10;12;0;22
070067;SAN GIULIANO DEL SANNIO;CB;958;9;4;0;13
070068;SAN GIULIANO DI PUGLIA;CB;989;8;5;0;13
015195;SAN GIULIANO MILANESE;MI;39253;19;13;0;32
050031;SAN GIULIANO TERME;PI;30836;21;9;0;30
082064;SAN GIUSEPPE JATO;PA;8204;0;0;3;3
063068;SAN GIUSEPPE VESUVIANO;NA;30045;0;0;3;3
054044;SAN GIUSTINO;PG;10956;13;9;0;22
001246;SAN GIUSTO CANAVESE;TO;3261;8;7;0;15
048039;SAN GODENZO;FI;1060;7;6;0;13
058095;SAN GREGORIO DA SASSOLA;RM;1457;12;1;0;13
087042;SAN GREGORIO DI CATANIA;CT;11487;13;9;0;22
065120;SAN GREGORIO MAGNO;SA;3990;11;6;0;17
061076;SAN GREGORIO MATESE;CE;888;13;0;0;13
025045;SAN GREGORIO NELLE ALPI;BL;1552;7;6;0;13
037054;SAN LAZZARO DI SAVENA;BO;32606;16;15;0;31
099025;SAN LEO;RN;2818;9;4;0;13
030102;SAN LEONARDO;UD;1045;11;6;0;17
021080;SAN LEONARDO IN PASSIRIA;BZ;3615;19;5;0;24
062060;SAN LEUCIO DEL SANNIO;BN;2949;10;3;0;13
062061;SAN LORENZELLO;BN;2125;11;2;0;13
080073;SAN LORENZO;RC;2271;9;4;0;13
008054;SAN LORENZO AL MARE;IM;1226;6;7;0;13
078120;SAN LORENZO BELLIZZI;CS;551;8;5;0;13
078121;SAN LORENZO DEL VALLO;CS;3098;12;5;0;17
021081;SAN LORENZO DI SEBATO;BZ;3845;19;5;0;24
022231;SAN LORENZO DORSINO;TN;1572;13;6;0;19
041054;SAN LORENZO IN CAMPO;PU;3201;8;9;0;17
031020;SAN LORENZO ISONTINO;GO;1506;9;6;0;15
062062;SAN LORENZO MAGGIORE;BN;1918;11;2;0;13
056047;SAN LORENZO NUOVO;VT;1994;10;3;0;13
080074;SAN LUCA;RC;3482;13;4;0;17
078122;SAN LUCIDO;CS;6005;7;10;0;17
062063;SAN LUPO;BN;723;11;2;0;13
079110;SAN MANGO D'AQUINO;CZ;1440;10;3;0;13
065121;SAN MANGO PIEMONTE;SA;2610;12;1;0;13
064082;SAN MANGO SUL CALORE;AV;1094;5;8;0;13
061077;SAN MARCELLINO;CE;14643;14;8;0;22
042041;SAN MARCELLO;AN;2026;10;3;0;13
047024;SAN MARCELLO PITEGLIO;PT;7671;11;6;0;17
078123;SAN MARCO ARGENTANO;CS;6942;9;8;0;17
083079;SAN MARCO D'ALUNZIO;ME;1812;10;5;0;15
062064;SAN MARCO DEI CAVOTI;BN;3014;11;6;0;17
061104;SAN MARCO EVANGELISTA;CE;6456;7;10;0;17
071047;SAN MARCO IN LAMIS;FG;12789;15;7;0;22
071048;SAN MARCO LA CATOLA;FG;890;10;3;0;13
093039;SAN MARTINO AL TAGLIAMENTO;PN;1453;8;7;0;15
005099;SAN MARTINO ALFIERI;AT;660;9;4;0;13
023073;SAN MARTINO BUON ALBERGO;VR;16021;13;9;0;22
001247;SAN MARTINO CANAVESE;TO;811;10;3;0;13
076077;SAN MARTINO D'AGRI;PZ;688;9;4;0;13
020059;SAN MARTINO DALL'ARGINE;MN;1598;8;4;0;12
019091;SAN MARTINO DEL LAGO;CR;397;8;5;0;13
078124;SAN MARTINO DI FINITA;CS;968;10;3;0;13
028077;SAN MARTINO DI LUPARI;PD;13184;14;8;0;22
029044;SAN MARTINO DI VENEZZE;RO;3758;12;5;0;17
021082;SAN MARTINO IN BADIA;BZ;1761;16;4;0;20
021083;SAN MARTINO IN PASSIRIA;BZ;3235;15;8;0;23
070069;SAN MARTINO IN PENSILIS;CB;4531;13;4;0;17
035037;SAN MARTINO IN RIO;RE;8194;10;7;0;17
098048;SAN MARTINO IN STRADA;LO;3710;10;7;0;17
062065;SAN MARTINO SANNITA;BN;1158;9;4;0;13
018137;SAN MARTINO SICCOMARIO;PV;6326;10;7;0;17
069082;SAN MARTINO SULLA MARRUCINA;CH;832;9;3;0;12
064083;SAN MARTINO VALLE CAUDINA;AV;4805;14;3;0;17
073025;SAN MARZANO DI SAN GIUSEPPE;TA;8963;9;8;0;17
005100;SAN MARZANO OLIVETO;AT;989;10;1;0;11
065122;SAN MARZANO SUL SARNO;SA;10325;9;13;0;22
070070;SAN MASSIMO;CB;802;13;0;0;13
001248;SAN MAURIZIO CANAVESE;TO;10228;9;8;0;17
003133;SAN MAURIZIO D'OPAGLIO;NO;2994;12;3;0;15
082065;SAN MAURO CASTELVERDE;PA;1384;8;6;0;14
065123;SAN MAURO CILENTO;SA;863;11;2;0;13
023074;SAN MAURO DI SALINE;VR;580;11;2;0;13
077026;SAN MAURO FORTE;MT;1287;10;3;0;13
065124;SAN MAURO LA BRUCA;SA;542;10;3;0;13
040041;SAN MAURO PASCOLI;FC;12192;11;11;0;22
001249;SAN MAURO TORINESE;TO;18635;12;9;0;21
027034;SAN MICHELE AL TAGLIAMENTO;VE;11431;14;8;0;22
022167;SAN MICHELE ALL'ADIGE;TN;4010;16;8;0;24
087043;SAN MICHELE DI GANZARIA;CT;2922;10;7;0;17
064084;SAN MICHELE DI SERINO;AV;2435;10;3;0;13
004210;SAN MICHELE MONDOVI';CN;1810;9;4;0;13
074014;SAN MICHELE SALENTINO;BR;6134;11;6;0;17
050032;SAN MINIATO;PI;27767;14;8;0;22
062066;SAN NAZZARO;BN;862;10;3;0;13
003134;SAN NAZZARO SESIA;NO;731;5;8;0;13
013207;SAN NAZZARO VAL CAVARGNA;CO;278;9;4;0;13
071049;SAN NICANDRO GARGANICO;FG;13986;16;6;0;22
078125;SAN NICOLA ARCELLA;CS;1949;9;4;0;13
064085;SAN NICOLA BARONIA;AV;757;10;3;0;13
061078;SAN NICOLA LA STRADA;CE;22232;14;8;0;22
062067;SAN NICOLA MANFREDI;BN;3524;12;5;0;17
095046;SAN NICOLO' D'ARCIDANO;OR;2526;11;6;0;17
025046;SAN NICOLO' DI COMELICO;BL;377;9;3;0;12
074015;SAN PANCRAZIO SALENTINO;BR;9386;11;11;0;22
021084;SAN PANCRAZIO;BZ;1517;12;7;0;19
017138;SAN PAOLO;BS;4417;11;6;0;17
076020;SAN PAOLO ALBANESE;PZ;220;9;4;0;13
063069;SAN PAOLO BEL SITO;NA;3370;15;2;0;17
016189;SAN PAOLO D'ARGON;BG;5802;10;7;0;17
071050;SAN PAOLO DI CIVITATE;FG;5563;11;6;0;17
042042;SAN PAOLO DI JESI;AN;885;8;5;0;13
005101;SAN PAOLO SOLBRITO;AT;1160;8;5;0;13
016190;SAN PELLEGRINO TERME;BG;4704;13;4;0;17
031021;SAN PIER D'ISONZO;GO;1993;11;6;0;17
083080;SAN PIER NICETO;ME;2632;11;4;0;15
083081;SAN PIERO PATTI;ME;2612;9;8;0;17
079114;SAN PIETRO A MAIDA;CZ;3812;11;6;0;17
030103;SAN PIETRO AL NATISONE;UD;2086;12;5;0;17
065125;SAN PIETRO AL TANAGRO;SA;1659;10;3;0;13
079115;SAN PIETRO APOSTOLO;CZ;1561;12;1;0;13
094043;SAN PIETRO AVELLANA;IS;439;12;1;0;13
087044;SAN PIETRO CLARENZA;CT;8229;12;5;0;17
025047;SAN PIETRO DI CADORE;BL;1542;6;7;0;13
080075;SAN PIETRO DI CARIDA';RC;1022;8;5;0;13
026073;SAN PIETRO DI FELETTO;TV;5141;10;7;0;17
023075;SAN PIETRO DI MORUBIO;VR;3054;12;5;0;17
078126;SAN PIETRO IN AMANTEA;CS;481;11;2;0;13
023076;SAN PIETRO IN CARIANO;VR;12888;12;10;0;22
037055;SAN PIETRO IN CASALE;BO;12661;13;9;0;22
033041;SAN PIETRO IN CERRO;PC;794;11;2;0;13
028078;SAN PIETRO IN GU;PD;4257;11;6;0;17
078127;SAN PIETRO IN GUARANO;CS;3434;10;7;0;17
075071;SAN PIETRO IN LAMA;LE;3390;14;3;0;17
061079;SAN PIETRO INFINE;CE;859;8;5;0;13
003135;SAN PIETRO MOSEZZO;NO;1971;8;5;0;13
024094;SAN PIETRO MUSSOLINO;VI;1544;7;6;0;13
001250;SAN PIETRO VAL LEMINA;TO;1457;8;5;0;13
074016;SAN PIETRO VERNOTICO;BR;13156;13;9;0;22
028079;SAN PIETRO VIMINARIO;PD;3048;11;4;0;15
066088;SAN PIO DELLE CAMERE;AQ;666;9;4;0;13
035038;SAN POLO D'ENZA;RE;6146;12;5;0;17
058096;SAN POLO DEI CAVALIERI;RM;2789;10;3;0;13
026074;SAN POLO DI PIAVE;TV;4914;10;5;0;15
070071;SAN POLO MATESE;CB;476;11;2;0;13
001251;SAN PONSO;TO;248;8;5;0;13
036038;SAN POSSIDONIO;MO;3451;9;7;0;16
061080;SAN POTITO SANNITICO;CE;1961;10;3;0;13
064086;SAN POTITO ULTRA;AV;1477;10;3;0;13
061081;SAN PRISCO;CE;12114;13;9;0;22
080076;SAN PROCOPIO;RC;495;7;4;0;11
036039;SAN PROSPERO;MO;6020;11;6;0;17
052030;SAN QUIRICO D'ORCIA;SI;2610;8;5;0;13
093040;SAN QUIRINO;PN;4191;12;10;0;22
001252;SAN RAFFAELE CIMENA;TO;3146;12;5;0;17
080077;SAN ROBERTO;RC;1551;11;2;0;13
098049;SAN ROCCO AL PORTO;LO;3347;8;9;0;17
046027;SAN ROMANO IN GARFAGNANA;LU;1352;7;6;0;13
065126;SAN RUFO;SA;1637;11;2;0;13
083082;SAN SALVATORE DI FITALIA;ME;1150;6;5;0;11
006154;SAN SALVATORE MONFERRATO;AL;4045;9;7;0;16
062068;SAN SALVATORE TELESINO;BN;3842;13;4;0;17
069083;SAN SALVO;CH;19555;13;9;0;22
063070;SAN SEBASTIANO AL VESUVIO;NA;8721;11;6;0;17
006155;SAN SEBASTIANO CURONE;AL;525;6;7;0;13
001253;SAN SEBASTIANO DA PO;TO;1861;9;4;0;13
001254;SAN SECONDO DI PINEROLO;TO;3597;10;7;0;17
034033;SAN SECONDO PARMENSE;PR;5816;10;7;0;17
076078;SAN SEVERINO LUCANO;PZ;1404;10;3;0;13
043047;SAN SEVERINO MARCHE;MC;11985;12;10;0;22
071051;SAN SEVERO;FG;49843;22;10;0;32
013248;SAN SIRO;CO;1693;9;4;0;13
064087;SAN SOSSIO BARONIA;AV;1523;13;0;0;13
079116;SAN SOSTENE;CZ;1414;8;5;0;13
078128;SAN SOSTI;CS;1879;11;2;0;13
027036;SAN STINO DI LIVENZA;VE;12720;13;9;0;22
061085;SAN TAMMARO;CE;5714;12;5;0;17
083090;SAN TEODORO;ME;1244;8;7;0;15
090092;SAN TEODORO;SS;4992;10;12;0;22
025049;SAN TOMASO AGORDINO;BL;608;8;3;0;11
068038;SAN VALENTINO IN ABRUZZO CITERIORE;PE;1858;8;5;0;13
065132;SAN VALENTINO TORIO;SA;10844;13;9;0;22
055030;SAN VENANZO;TR;2182;8;5;0;13
026076;SAN VENDEMIANO;TV;9884;13;9;0;22
095050;SAN VERO MILIS;OR;2434;9;8;0;17
049018;SAN VINCENZO;LI;6498;10;7;0;17
078135;SAN VINCENZO LA COSTA;CS;2022;8;5;0;13
066092;SAN VINCENZO VALLE ROVETO;AQ;2115;9;4;0;13
063075;SAN VITALIANO;NA;6421;8;9;0;17
093041;SAN VITO AL TAGLIAMENTO;PN;15097;19;13;0;32
030105;SAN VITO AL TORRE;UD;1202;0;0;1;1
069086;SAN VITO CHIETINO;CH;5175;9;8;0;17
074017;SAN VITO DEI NORMANNI;BR;18267;14;8;0;22
025051;SAN VITO DI CADORE;BL;1935;0;0;1;1
030106;SAN VITO DI FAGAGNA;UD;1679;9;6;0;15
024096;SAN VITO DI LEGUZZANO;VI;3571;9;8;0;17
058100;SAN VITO ROMANO;RM;3075;12;5;0;17
079122;SAN VITO SULLO IONIO;CZ;1629;8;5;0;13
060070;SAN VITTORE DEL LAZIO;FR;2474;11;2;0;13
015201;SAN VITTORE OLONA;MI;8259;8;9;0;17
023079;SAN ZENO DI MONTAGNA;VR;1440;9;4;0;13
017173;SAN ZENO NAVIGLIO;BS;4704;14;3;0;17
015202;SAN ZENONE AL LAMBRO;MI;4489;11;6;0;17
018145;SAN ZENONE AL PO;PV;540;8;5;0;13
026077;SAN ZENONE DEGLI EZZELINI;TV;7282;11;6;0;17
075067;SANARICA;LE;1469;11;1;0;12
096059;SANDIGLIANO;BI;2570;8;5;0;13
024091;SANDRIGO;VI;8221;10;7;0;17
004208;SANFRE';CN;3050;7;6;0;13
004209;SANFRONT;CN;2289;9;4;0;13
001241;SANGANO;TO;3686;12;5;0;17
012141;SANGIANO;VA;1459;8;5;0;13
078117;SANGINETO;CS;1244;9;4;0;13
023072;SANGUINETTO;VR;4069;12;5;0;17
018138;SANNAZZARO DE' BURGONDI;PV;5098;8;9;0;17
072040;SANNICANDRO DI BARI;BA;9592;10;7;0;17
075070;SANNICOLA;LE;5702;9;8;0;17
008055;SANREMO;IM;52918;21;11;0;32
051034;SANSEPOLCRO;AR;15227;16;6;0;22
094044;SANT'AGAPITO;IS;1411;8;5;0;13
037056;SANT'AGATA BOLOGNESE;BO;7335;11;6;0;17
062070;SANT'AGATA DE' GOTI;BN;10388;13;9;0;22
080079;SANT'AGATA DEL BIANCO;RC;591;8;5;0;13
078131;SANT'AGATA DI ESARO;CS;1715;8;5;0;13
083084;SANT'AGATA DI MILITELLO;ME;11950;14;8;0;22
071052;SANT'AGATA DI PUGLIA;FG;1831;10;3;0;13
099026;SANT'AGATA FELTRIA;RN;1998;11;2;0;13
006156;SANT'AGATA FOSSILI;AL;367;10;3;0;13
087045;SANT'AGATA LI BATTIATI;CT;9338;12;6;0;18
039017;SANT'AGATA SUL SANTERNO;RA;2869;8;5;0;13
063071;SANT'AGNELLO;NA;8729;11;6;0;17
004211;SANT'ALBANO STURA;CN;2357;10;3;0;13
018141;SANT'ALESSIO CON VIALONE;PV;1017;11;2;0;13
080080;SANT'ALESSIO IN ASPROMONTE;RC;331;12;1;0;13
083085;SANT'ALESSIO SICULO;ME;1527;9;5;0;14
087046;SANT'ALFIO;CT;1518;8;7;0;15
001255;SANT'AMBROGIO DI TORINO;TO;4597;13;4;0;17
023077;SANT'AMBROGIO DI VALPOLICELLA;VR;11923;15;7;0;22
060065;SANT'AMBROGIO SUL GARIGLIANO;FR;879;8;5;0;13
063072;SANT'ANASTASIA;NA;26460;15;6;0;21
054045;SANT'ANATOLIA DI NARCO;PG;526;8;5;0;13
079118;SANT'ANDREA APOSTOLO DELLO IONIO;CZ;1759;11;2;0;13
060066;SANT'ANDREA DEL GARIGLIANO;FR;1311;9;4;0;13
064089;SANT'ANDREA DI CONZA;AV;1368;10;3;0;13
062071;SANT'ANGELO A CUPOLO;BN;4117;12;5;0;17
065128;SANT'ANGELO A FASANELLA;SA;514;10;3;0;13
064091;SANT'ANGELO A SCALA;AV;702;11;2;0;13
064090;SANT'ANGELO ALL'ESCA;AV;747;8;5;0;13
061086;SANT'ANGELO D'ALIFE;CE;2089;7;6;0;13
064092;SANT'ANGELO DEI LOMBARDI;AV;3913;13;4;0;17
094046;SANT'ANGELO DEL PESCO;IS;325;7;6;0;13
083088;SANT'ANGELO DI BROLO;ME;2806;11;6;0;17
028082;SANT'ANGELO DI PIOVE DI SACCO;PD;7289;11;6;0;17
043048;SANT'ANGELO IN PONTANO;MC;1244;9;4;0;13
041057;SANT'ANGELO IN VADO;PU;3907;9;8;0;17
076079;SANT'ANGELO LE FRATTE;PZ;1314;9;4;0;13
070073;SANT'ANGELO LIMOSANO;CB;317;11;2;0;13
098050;SANT'ANGELO LODIGIANO;LO;13346;0;0;1;1
018144;SANT'ANGELO LOMELLINA;PV;817;6;7;0;13
084039;SANT'ANGELO MUXARO;AG;1182;8;7;0;15
058098;SANT'ANGELO ROMANO;RM;4945;12;5;0;17
023078;SANT'ANNA D'ALFAEDO;VR;2540;10;3;0;13
063073;SANT'ANTIMO;NA;32576;0;0;1;1
001256;SANT'ANTONINO DI SUSA;TO;4064;11;6;0;17
063074;SANT'ANTONIO ABATE;NA;19169;14;8;0;22
090085;SANT'ANTONIO DI GALLURA;SS;1443;10;5;0;15
060067;SANT'APOLLINARE;FR;1842;10;3;0;13
076080;SANT'ARCANGELO;PZ;6032;12;5;0;17
062078;SANT'ARCANGELO TRIMONTE;BN;480;10;3;0;13
061087;SANT'ARPINO;CE;14910;14;8;0;22
065129;SANT'ARSENIO;SA;2685;9;4;0;13
067038;SANT'EGIDIO ALLA VIBRATA;TE;9804;9;8;0;17
065130;SANT'EGIDIO DEL MONTE ALBINO;SA;8857;11;6;0;17
028083;SANT'ELENA;PD;2530;10;3;0;13
094047;SANT'ELENA SANNITA;IS;270;10;3;0;13
070074;SANT'ELIA A PIANISI;CB;1585;8;5;0;13
060068;SANT'ELIA FIUMERAPIDO;FR;5732;11;8;0;19
068037;SANT'EUFEMIA A MAIELLA;PE;265;9;4;0;13
080081;SANT'EUFEMIA D'ASPROMONTE;RC;3740;11;7;0;18
069085;SANT'EUSANIO DEL SANGRO;CH;2279;10;3;0;13
066090;SANT'EUSANIO FORCONESE;AQ;359;9;4;0;13
035039;SANT'ILARIO D'ENZA;RE;11205;12;10;0;22
080082;SANT'ILARIO DELLO IONIO;RC;1348;9;4;0;13
041058;SANT'IPPOLITO;PU;1459;9;4;0;13
010055;SANT'OLCESE;GE;5601;7;10;0;17
067039;SANT'OMERO;TE;5112;9;8;0;17
016252;SANT'OMOBONO TERME;BG;3862;11;4;0;15
058099;SANT'ORESTE;RM;3504;8;9;0;17
022168;SANT'ORSOLA TERME;TN;1106;13;7;0;20
028084;SANT'URBANO;PD;1903;9;4;0;13
016191;SANTA BRIGIDA;BG;523;10;3;0;13
078129;SANTA CATERINA ALBANESE;CS;1128;13;0;0;13
079117;SANTA CATERINA DELLO IONIO;CZ;1940;10;4;0;14
085017;SANTA CATERINA VILLARMOSA;CL;4785;12;5;0;17
075072;SANTA CESAREA TERME;LE;2847;13;0;0;13
080078;SANTA CRISTINA D'ASPROMONTE;RC;774;9;4;0;13
018139;SANTA CRISTINA E BISSONE;PV;1873;8;5;0;13
082066;SANTA CRISTINA GELA;PA;990;6;8;0;14
021085;SANTA CRISTINA VALGARDENA;BZ;2001;16;4;0;20
088010;SANTA CROCE CAMERINA;RG;10912;10;7;0;17
062069;SANTA CROCE DEL SANNIO;BN;858;11;1;0;12
070072;SANTA CROCE DI MAGLIANO;CB;4012;12;5;0;17
050033;SANTA CROCE SULL'ARNO;PI;14608;12;10;0;22
078130;SANTA DOMENICA TALAO;CS;1140;13;0;0;13
083083;SANTA DOMENICA VITTORIA;ME;873;11;4;0;15
084037;SANTA ELISABETTA;AG;2172;9;6;0;15
053022;SANTA FIORA;GR;2485;9;4;0;13
082067;SANTA FLAVIA;PA;10999;14;8;0;22
018140;SANTA GIULETTA;PV;1563;6;7;0;13
095047;SANTA GIUSTA;OR;4646;10;7;0;17
025048;SANTA GIUSTINA;BL;6634;11;6;0;17
028080;SANTA GIUSTINA IN COLLE;PD;7156;10;7;0;17
050034;SANTA LUCE;PI;1637;8;5;0;13
083086;SANTA LUCIA DEL MELA;ME;4428;10;7;0;17
026075;SANTA LUCIA DI PIAVE;TV;9127;9;8;0;17
064088;SANTA LUCIA DI SERINO;AV;1405;10;3;0;13
084038;SANTA MARGHERITA DI BELICE;AG;6097;12;6;0;18
018142;SANTA MARGHERITA DI STAFFORA;PV;448;10;3;0;13
010054;SANTA MARGHERITA LIGURE;GE;8575;9;8;0;17
050035;SANTA MARIA A MONTE;PI;13307;10;12;0;22
061082;SANTA MARIA A VICO;CE;14249;12;6;0;18
061083;SANTA MARIA CAPUA VETERE;CE;31934;24;8;0;32
090087;SANTA MARIA COGHINAS;SS;1309;14;3;0;17
078132;SANTA MARIA DEL CEDRO;CS;4949;10;5;0;15
094045;SANTA MARIA DEL MOLISE;IS;664;11;2;0;13
018143;SANTA MARIA DELLA VERSA;PV;2242;9;4;0;13
087047;SANTA MARIA DI LICODIA;CT;7453;9;8;0;17
027035;SANTA MARIA DI SALA;VE;17449;13;8;0;21
097074;SANTA MARIA HOE';LC;2130;10;3;0;13
069084;SANTA MARIA IMBARO;CH;2020;8;5;0;13
063090;SANTA MARIA LA CARITA';NA;11689;16;6;0;22
061084;SANTA MARIA LA FOSSA;CE;2559;13;0;0;13
030104;SANTA MARIA LA LONGA;UD;2313;9;8;0;17
042043;SANTA MARIA NUOVA;AN;3980;11;6;0;17
065127;SANTA MARINA;SA;3198;13;4;0;17
083087;SANTA MARINA SALINA;ME;854;11;4;0;15
058097;SANTA MARINELLA;RM;18531;12;10;0;22
081019;SANTA NINFA;TP;4838;9;8;0;17
064093;SANTA PAOLINA;AV;1175;6;7;0;13
040043;SANTA SOFIA;FC;4018;11;6;0;17
078133;SANTA SOFIA D'EPIRO;CS;2205;8;5;0;13
083089;SANTA TERESA DI RIVA;ME;9337;10;7;0;17
090063;SANTA TERESA GALLURA;SS;5006;14;8;0;22
087048;SANTA VENERINA;CT;8421;9;9;0;18
004212;SANTA VITTORIA D'ALBA;CN;2874;9;4;0;13
099018;SANTARCANGELO DI ROMAGNA;RN;22184;13;9;0;22
066089;SANTE MARIE;AQ;1099;10;3;0;13
001257;SANTENA;TO;10531;13;9;0;22
072041;SANTERAMO IN COLLE;BA;25870;17;5;0;22
002133;SANTHIA';VC;8109;11;6;0;17
059026;SANTI COSMA E DAMIANO;LT;6854;10;7;0;17
008056;SANTO STEFANO AL MARE;IM;2031;8;5;0;13
004213;SANTO STEFANO BELBO;CN;3823;15;2;0;17
010056;SANTO STEFANO D'AVETO;GE;991;7;5;0;12
064095;SANTO STEFANO DEL SOLE;AV;2076;8;5;0;13
025050;SANTO STEFANO DI CADORE;BL;2405;8;5;0;13
083091;SANTO STEFANO DI CAMASTRA;ME;4415;10;7;0;17
011026;SANTO STEFANO DI MAGRA;SP;9837;10;7;0;17
078134;SANTO STEFANO DI ROGLIANO;CS;1704;9;4;0;13
066091;SANTO STEFANO DI SESSANIO;AQ;115;11;2;0;13
080083;SANTO STEFANO IN ASPROMONTE;RC;1091;11;2;0;13
098051;SANTO STEFANO LODIGIANO;LO;1849;10;3;0;13
084040;SANTO STEFANO QUISQUINA;AG;4159;8;9;0;17
004214;SANTO STEFANO ROERO;CN;1325;10;3;0;13
015200;SANTO STEFANO TICINO;MI;4932;11;6;0;17
065131;SANTOMENNA;SA;401;9;4;0;13
060069;SANTOPADRE;FR;1215;11;2;0;13
024095;SANTORSO;VI;5530;9;8;0;17
095049;SANTU LUSSURGIU;OR;2229;12;5;0;17
065133;SANZA;SA;2372;9;4;0;13
022169;SANZENO;TN;919;11;4;0;15
028085;SAONARA;PD;10476;12;10;0;22
083092;SAPONARA;ME;3704;12;5;0;17
030189;SAPPADA;UD;1308;13;4;0;17
065134;SAPRI;SA;6401;9;8;0;17
078136;SARACENA;CS;3451;10;7;0;17
058101;SARACINESCO;RM;166;12;1;0;13
024097;SARCEDO;VI;5337;9;8;0;17
076081;SARCONI;PZ;1406;8;5;0;13
006157;SARDIGLIANO;AL;386;10;3;0;13
024098;SAREGO;VI;6709;10;6;0;16
021086;SARENTINO;BZ;7190;16;8;0;24
006158;SAREZZANO;AL;1124;8;5;0;13
017174;SAREZZO;BS;13132;11;11;0;22
033042;SARMATO;PC;2950;7;6;0;13
026078;SARMEDE;TV;2951;8;9;0;17
043049;SARNANO;MC;3069;11;6;0;17
016193;SARNICO;BG;6731;10;7;0;17
065135;SARNO;SA;30652;21;11;0;32
022170;SARNONICO;TN;795;10;4;0;14
012119;SARONNO;VA;38582;22;10;0;32
007066;SARRE;AO;4755;13;7;0;20
092066;SARROCH;CA;5057;14;9;0;23
040044;SARSINA;FC;3303;11;6;0;17
052031;SARTEANO;SI;4476;5;12;0;17
018146;SARTIRANA LOMELLINA;PV;1457;8;5;0;13
091077;SARULE;NU;1564;12;3;0;15
011027;SARZANA;SP;21610;17;5;0;22
065136;SASSANO;SA;4634;15;2;0;17
090064;SASSARI;SS;122159;34;10;0;44
009055;SASSELLO;SV;1747;8;5;0;13
049019;SASSETTA;LI;475;8;5;0;13
062072;SASSINORO;BN;633;8;5;0;13
076082;SASSO DI CASTALDA;PZ;751;10;3;0;13
037057;SASSO MARCONI;BO;14798;14;8;0;22
041071;SASSOCORVARO AUDITORE;PU;4870;11;6;0;17
099031;SASSOFELTRIO;RN;1366;8;5;0;13
042044;SASSOFERRATO;AN;6875;11;6;0;17
036040;SASSUOLO;MO;40469;21;10;0;31
079123;SATRIANO;CZ;3360;11;6;0;17
076083;SATRIANO DI LUCANIA;PZ;2249;11;2;0;13
030107;SAURIS;UD;390;10;5;0;15
001259;SAUZE D'OULX;TO;1043;10;3;0;13
001258;SAUZE DI CESANA;TO;251;8;5;0;13
073026;SAVA;TA;15423;14;8;0;22
063076;SAVIANO;NA;15933;12;10;0;22
004215;SAVIGLIANO;CN;21453;16;6;0;22
064096;SAVIGNANO IRPINO;AV;1026;7;6;0;13
036041;SAVIGNANO SUL PANARO;MO;9415;9;8;0;17
040045;SAVIGNANO SUL RUBICONE;FC;17797;15;7;0;22
010057;SAVIGNONE;GE;3038;9;8;0;17
017175;SAVIORE DELL'ADAMELLO;BS;802;10;3;0;13
083093;SAVOCA;ME;1697;9;6;0;15
030108;SAVOGNA;UD;351;6;7;0;13
031022;SAVOGNA D'ISONZO;GO;1694;9;8;0;17
076084;SAVOIA DI LUCANIA;PZ;1020;8;5;0;13
009056;SAVONA;SV;58534;28;14;0;42
068039;SCAFA;PE;3508;12;5;0;17
065137;SCAFATI;SA;48421;21;9;0;30
004216;SCAGNELLO;CN;174;8;5;0;13
065138;SCALA;SA;1504;11;2;0;13
078137;SCALA COELI;CS;828;10;3;0;13
018147;SCALDASOLE;PV;852;9;2;0;11
078138;SCALEA;CS;11076;15;7;0;22
001260;SCALENGHE;TO;3244;12;5;0;17
083094;SCALETTA ZANCLEA;ME;1871;10;5;0;15
064097;SCAMPITELLA;AV;1049;10;3;0;13
035040;SCANDIANO;RE;25767;14;8;0;22
048041;SCANDICCI;FI;49659;19;13;0;32
019092;SCANDOLARA RAVARA;CR;1297;7;4;0;11
019093;SCANDOLARA RIPA D'OGLIO;CR;532;9;4;0;13
057064;SCANDRIGLIA;RI;3232;10;3;0;13
066093;SCANNO;AQ;1723;11;2;0;13
095051;SCANO DI MONTIFERRO;OR;1417;12;4;0;16
053023;SCANSANO;GR;4263;12;5;0;17
077031;SCANZANO JONICO;MT;7525;9;8;0;17
016194;SCANZOROSCIATE;BG;9881;9;7;0;16
094048;SCAPOLI;IS;591;12;1;0;13
053024;SCARLINO;GR;3814;12;5;0;17
001261;SCARMAGNO;TO;802;8;5;0;13
004217;SCARNAFIGI;CN;2149;10;3;0;13
048053;SCARPERIA E SAN PIERO;FI;12018;10;9;0;19
021087;SCENA;BZ;2980;13;7;0;20
069087;SCERNI;CH;3020;11;6;0;17
054046;SCHEGGIA E PASCELUPO;PG;1280;10;3;0;13
054047;SCHEGGINO;PG;451;7;6;0;13
069088;SCHIAVI DI ABRUZZO;CH;679;9;4;0;13
024099;SCHIAVON;VI;2603;8;5;0;13
013211;SCHIGNANO;CO;884;8;3;0;11
016195;SCHILPARIO;BG;1140;9;4;0;13
024100;SCHIO;VI;38533;23;9;0;32
020060;SCHIVENOGLIA;MN;1090;6;7;0;13
084041;SCIACCA;AG;39263;28;6;0;34
082068;SCIARA;PA;2569;7;8;0;15
088011;SCICLI;RG;26878;12;10;0;22
080084;SCIDO;RC;841;9;4;0;13
078139;SCIGLIANO;CS;1116;9;4;0;13
080085;SCILLA;RC;4576;0;0;3;3
082081;SCILLATO;PA;614;9;6;0;15
001262;SCIOLZE;TO;1463;8;5;0;13
063077;SCISCIANO;NA;6150;9;8;0;17
082069;SCLAFANI BAGNI;PA;387;8;6;0;14
066094;SCONTRONE;AQ;555;10;1;0;11
002134;SCOPA;VC;373;6;4;0;10
002135;SCOPELLO;VC;372;10;2;0;12
066095;SCOPPITO;AQ;3762;13;4;0;17
087049;SCORDIA;CT;16211;15;7;0;22
075073;SCORRANO;LE;6726;10;7;0;17
027037;SCORZE';VE;18965;13;9;0;22
066096;SCURCOLA MARSICANA;AQ;2698;10;3;0;13
022171;SCURELLE;TN;1334;11;6;0;17
005103;SCURZOLENGO;AT;516;10;3;0;13
008057;SEBORGA;IM;281;8;5;0;13
066097;SECINARO;AQ;321;5;8;0;13
075074;SECLI';LE;1820;10;3;0;13
098052;SECUGNAGO;LO;1945;8;5;0;13
030109;SEDEGLIANO;UD;3704;11;11;0;22
025053;SEDICO;BL;10161;11;6;0;17
095052;SEDILO;OR;1995;12;5;0;17
090065;SEDINI;SS;1256;12;5;0;17
015204;SEDRIANO;MI;12551;11;11;0;22
016196;SEDRINA;BG;2438;8;5;0;13
043050;SEFRO;MC;418;8;5;0;13
053025;SEGGIANO;GR;983;10;3;0;13
058102;SEGNI;RM;8983;12;5;0;17
022172;SEGONZANO;TN;1388;9;10;0;19
015205;SEGRATE;MI;36591;22;10;0;32
026079;SEGUSINO;TV;1823;9;4;0;13
092068;SELARGIUS;CA;28648;20;10;0;30
057065;SELCI;RI;1112;6;7;0;13
022246;SELLA GIUDICARIE;TN;2892;17;3;0;20
054048;SELLANO;PG;1002;10;3;0;13
017176;SELLERO;BS;1400;10;3;0;13
079126;SELLIA;CZ;494;0;0;1;1
079127;SELLIA MARINA;CZ;7579;9;8;0;17
021088;SELVA DEI MOLINI;BZ;1399;16;4;0;20
025054;SELVA DI CADORE;BL;493;9;4;0;13
023080;SELVA DI PROGNO;VR;884;10;3;0;13
021089;SELVA DI VAL GARDENA;BZ;2592;12;7;0;19
028086;SELVAZZANO DENTRO;PD;22961;8;3;1;12
016197;SELVINO;BG;2000;9;4;0;13
090066;SEMESTENE;SS;141;6;8;0;14
018148;SEMIANA;PV;197;8;5;0;13
080086;SEMINARA;RC;2488;11;2;0;13
053028;SEMPRONIANO;GR;984;10;3;0;13
015206;SENAGO;MI;21360;12;10;0;22
021118;SENALE-SAN FELICE;BZ;781;13;4;0;17
021091;SENALES;BZ;1261;15;5;0;20
095053;SENEGHE;OR;1682;9;4;0;13
064098;SENERCHIA;AV;751;8;5;0;13
017177;SENIGA;BS;1427;7;6;0;13
042045;SENIGALLIA;AN;44245;19;13;0;32
095054;SENIS;OR;424;9;5;0;14
076085;SENISE;PZ;6635;9;7;0;16
013212;SENNA COMASCO;CO;3161;8;9;0;17
098053;SENNA LODIGIANA;LO;1764;7;6;0;13
095055;SENNARIOLO;OR;155;7;7;0;14
090067;SENNORI;SS;6935;13;9;0;22
070075;SEPINO;CB;1795;10;3;0;13
093042;SEQUALS;PN;2170;10;7;0;17
046028;SERAVEZZA;LU;12441;11;11;0;22
025055;SEREN DEL GRAPPA;BL;2375;8;5;0;13
019094;SERGNANO;CR;3505;12;5;0;17
016198;SERIATE;BG;25169;18;4;0;22
016199;SERINA;BG;2051;9;4;0;13
064099;SERINO;AV;6769;10;7;0;17
017178;SERLE;BS;3060;11;6;0;17
020061;SERMIDE E FELONICA;MN;7112;9;8;0;17
059027;SERMONETA;LT;10044;11;6;0;17
026080;SERNAGLIA DELLA BATTAGLIA;TV;6086;9;7;0;16
014059;SERNIO;SO;475;9;4;0;13
005104;SEROLE;AT;102;7;6;0;13
042046;SERRA DE' CONTI;AN;3558;14;3;0;17
010058;SERRA RICCO';GE;7615;9;8;0;17
042047;SERRA SAN QUIRICO;AN;2552;7;6;0;13
041061;SERRA SANT'ABBONDIO;PU;919;5;6;0;11
071053;SERRACAPRIOLA;FG;3704;14;3;0;17
085018;SERRADIFALCO;CL;5588;9;8;0;17
004218;SERRALUNGA D'ALBA;CN;554;9;4;0;13
006159;SERRALUNGA DI CREA;AL;509;10;3;0;13
036042;SERRAMAZZONI;MO;8516;10;7;0;17
065139;SERRAMEZZANA;SA;290;9;4;0;13
068040;SERRAMONACESCA;PE;531;9;4;0;13
043051;SERRAPETRONA;MC;896;7;6;0;13
063078;SERRARA FONTANA;NA;3044;11;6;0;17
079129;SERRASTRETTA;CZ;2945;12;2;0;14
080087;SERRATA;RC;796;11;2;0;13
020062;SERRAVALLE A PO;MN;1441;5;6;0;11
043052;SERRAVALLE DI CHIENTI;MC;1055;11;2;0;13
004219;SERRAVALLE LANGHE;CN;300;10;2;0;12
047020;SERRAVALLE PISTOIESE;PT;11742;11;6;0;17
006160;SERRAVALLE SCRIVIA;AL;5878;10;7;0;17
002137;SERRAVALLE SESIA;VC;4751;11;6;0;17
065140;SERRE;SA;3701;12;5;0;17
060071;SERRONE;FR;3016;10;7;0;17
079130;SERSALE;CZ;4291;13;4;0;17
061088;SESSA AURUNCA;CE;20366;16;6;0;22
065141;SESSA CILENTO;SA;1200;11;2;0;13
005105;SESSAME;AT;239;12;1;0;13
094049;SESSANO DEL MOLISE;IS;663;12;1;0;13
011028;SESTA GODANO;SP;1273;8;5;0;13
051035;SESTINO;AR;1218;6;5;0;11
093043;SESTO AL REGHENA;PN;6301;13;8;0;21
012120;SESTO CALENDE;VA;10969;13;9;0;22
094050;SESTO CAMPANO;IS;2140;9;4;0;13
019095;SESTO ED UNITI;CR;3185;11;6;0;17
048043;SESTO FIORENTINO;FI;48782;21;11;0;32
015209;SESTO SAN GIOVANNI;MI;79442;23;9;0;32
021092;SESTO;BZ;1846;14;6;0;20
036043;SESTOLA;MO;2443;9;4;0;13
010059;SESTRI LEVANTE;GE;17607;15;7;0;22
001263;SESTRIERE;TO;919;10;3;0;13
092074;SESTU;CA;20800;16;11;0;27
015210;SETTALA;MI;7267;7;10;0;17
060072;SETTEFRATI;FR;709;10;3;0;13
005106;SETTIME;AT;559;9;4;0;13
015211;SETTIMO MILANESE;MI;20062;14;8;0;22
001264;SETTIMO ROTTARO;TO;473;11;2;0;13
092075;SETTIMO SAN PIETRO;CA;6882;13;9;0;22
001265;SETTIMO TORINESE;TO;46056;16;16;0;32
001266;SETTIMO VITTONE;TO;1491;8;5;0;13
079131;SETTINGIANO;CZ;3204;8;4;0;12
006161;SEZZADIO;AL;1174;8;5;0;13
059028;SEZZE;LT;23726;16;5;0;21
022173;SFRUZ;TN;370;6;9;0;15
032005;SGONICO;TS;1999;11;5;0;16
060073;SGURGOLA;FR;2389;10;3;0;13
095056;SIAMAGGIORE;OR;884;10;2;0;12
095057;SIAMANNA;OR;773;9;5;0;14
065142;SIANO;SA;9496;14;8;0;22
095076;SIAPICCIA;OR;344;9;5;0;14
065143;SICIGNANO DEGLI ALBURNI;SA;3101;14;3;0;17
084042;SICULIANA;AG;4176;11;6;0;17
080088;SIDERNO;RC;17610;14;8;0;22
052032;SIENA;SI;53062;24;18;0;42
054049;SIGILLO;PG;2305;9;4;0;13
048044;SIGNA;FI;18964;17;5;0;22
021093;SILANDRO;BZ;6290;13;12;0;25
091083;SILANUS;NU;2018;9;7;0;16
026081;SILEA;TV;10219;9;8;0;17
090068;SILIGO;SS;812;9;5;0;14
046037;SILLANO GIUNCUGNANO;LU;999;10;3;0;13
003138;SILLAVENGO;NO;556;9;4;0;13
006162;SILVANO D'ORBA;AL;1914;8;5;0;13
018149;SILVANO PIETRA;PV;632;7;6;0;13
067040;SILVI;TE;15388;15;7;0;22
095058;SIMALA;OR;284;7;3;0;10
095059;SIMAXIS;OR;2146;11;6;0;17
079133;SIMERI CRICHI;CZ;4748;0;0;3;3
083095;SINAGRA;ME;2498;8;7;0;15
052033;SINALUNGA;SI;12128;12;10;0;22
091084;SINDIA;NU;1609;5;5;0;10
095060;SINI;OR;485;12;2;0;14
004220;SINIO;CN;478;8;5;0;13
091085;SINISCOLA;NU;11245;14;8;0;22
092080;SINNAI;CA;17323;19;8;0;27
080089;SINOPOLI;RC;1891;11;2;0;13
089017;SIRACUSA;SR;117055;55;18;0;73
064100;SIRIGNANO;AV;2831;10;3;0;13
095061;SIRIS;OR;223;6;8;0;14
017179;SIRMIONE;BS;8257;9;8;0;17
042048;SIROLO;AN;4096;9;8;0;17
097075;SIRONE;LC;2305;8;5;0;13
097076;SIRTORI;LC;2777;11;2;0;13
034049;SISSA TRECASALI;PR;7842;8;9;0;17
018150;SIZIANO;PV;6451;11;6;0;17
003139;SIZZANO;NO;1360;8;5;0;13
021094;SLUDERNO;BZ;1834;13;6;0;19
023081;SOAVE;VR;7156;10;7;0;17
030110;SOCCHIEVE;UD;860;6;8;0;14
095078;SODDI';OR;120;9;5;0;14
040046;SOGLIANO AL RUBICONE;FC;3147;11;6;0;17
075075;SOGLIANO CAVOUR;LE;3932;12;5;0;17
005107;SOGLIO;AT;135;11;2;0;13
017180;SOIANO DEL LAGO;BS;1949;6;7;0;13
024101;SOLAGNA;VI;1807;9;4;0;13
089018;SOLARINO;SR;7578;10;8;0;18
015213;SOLARO;MI;13924;13;9;0;22
039018;SOLAROLO;RA;4393;10;7;0;17
019096;SOLAROLO RAINERIO;CR;900;7;6;0;13
095062;SOLARUSSA;OR;2291;12;5;0;17
012121;SOLBIATE ARNO;VA;4021;11;6;0;17
013255;SOLBIATE CON CAGNO;CO;4631;13;4;0;17
012122;SOLBIATE OLONA;VA;5359;8;9;0;17
008058;SOLDANO;IM;996;9;4;0;13
006163;SOLERO;AL;1565;8;5;0;13
028087;SOLESINO;PD;6810;12;5;0;17
075076;SOLETO;LE;5236;12;5;0;17
020063;SOLFERINO;MN;2621;8;5;0;13
036044;SOLIERA;MO;15425;13;9;0;22
034035;SOLIGNANO;PR;1701;8;5;0;13
064101;SOLOFRA;AV;12163;14;8;0;22
006164;SOLONGHELLO;AL;195;13;0;0;13
062073;SOLOPACA;BN;3517;13;4;0;17
016200;SOLTO COLLINA;BG;1779;9;2;0;11
016251;SOLZA;BG;1985;7;6;0;13
098054;SOMAGLIA;LO;3839;12;5;0;17
004221;SOMANO;CN;310;11;2;0;13
012123;SOMMA LOMBARDO;VA;17749;14;8;0;22
063079;SOMMA VESUVIANA;NA;33935;24;8;0;32
023082;SOMMACAMPAGNA;VR;14572;13;9;0;22
004222;SOMMARIVA DEL BOSCO;CN;6271;10;7;0;17
004223;SOMMARIVA PERNO;CN;2694;8;5;0;13
085019;SOMMATINO;CL;6441;10;7;0;17
018151;SOMMO;PV;1145;6;7;0;13
023083;SONA;VR;17585;17;5;0;22
019097;SONCINO;CR;7507;8;9;0;17
014060;SONDALO;SO;3930;12;5;0;17
014061;SONDRIO;SO;21192;28;14;0;42
016201;SONGAVAZZO;BG;696;8;5;0;13
017181;SONICO;BS;1211;8;5;0;13
059029;SONNINO;LT;7440;11;6;0;17
060074;SORA;FR;25059;16;8;0;24
022176;SORAGA DI FASSA;TN;695;12;4;0;16
034036;SORAGNA;PR;4778;7;10;0;17
053026;SORANO;GR;3097;11;6;0;17
079134;SORBO SAN BASILE;CZ;773;9;4;0;13
064102;SORBO SERPICO;AV;534;6;7;0;13
034051;SORBOLO MEZZANI;PR;12719;12;10;0;22
096063;SORDEVOLO;BI;1299;9;4;0;13
098055;SORDIO;LO;3387;13;4;0;17
019098;SORESINA;CR;8744;9;8;0;17
023084;SORGA';VR;2930;13;4;0;17
091086;SORGONO;NU;1529;10;6;0;16
010060;SORI;GE;4018;10;7;0;17
056048;SORIANO NEL CIMINO;VT;8021;12;5;0;17
013216;SORICO;CO;1246;9;4;0;13
003140;SORISO;NO;719;9;4;0;13
016202;SORISOLE;BG;8901;10;7;0;17
013217;SORMANO;CO;643;8;4;0;12
095063;SORRADILE;OR;349;9;5;0;14
063080;SORRENTO;NA;15600;15;7;0;22
090069;SORSO;SS;14501;14;8;0;22
089019;SORTINO;SR;8298;11;7;0;18
019099;SOSPIRO;CR;3050;13;4;0;17
025056;SOSPIROLO;BL;3053;12;5;0;17
024102;SOSSANO;VI;4185;13;4;0;17
096064;SOSTEGNO;BI;740;12;1;0;13
016203;SOTTO IL MONTE GIOVANNI XXIII;BG;4401;12;5;0;17
022177;SOVER;TN;773;7;9;0;16
079137;SOVERATO;CZ;8683;8;9;0;17
016204;SOVERE;BG;5229;9;8;0;17
079138;SOVERIA MANNELLI;CZ;2903;12;5;0;17
079139;SOVERIA SIMERI;CZ;1461;10;3;0;13
025057;SOVERZENE;BL;364;8;5;0;13
052034;SOVICILLE;SI;9906;9;8;0;17
024103;SOVIZZO;VI;7454;10;7;0;17
025058;SOVRAMONTE;BL;1311;9;4;0;13
003141;SOZZAGO;NO;1088;8;5;0;13
083096;SPADAFORA;ME;4682;9;8;0;17
061089;SPARANISE;CE;7220;0;0;3;3
001267;SPARONE;TO;928;8;5;0;13
075077;SPECCHIA;LE;4602;11;6;0;17
054050;SPELLO;PG;8314;11;6;0;17
086017;SPERLINGA;EN;697;9;6;0;15
059030;SPERLONGA;LT;3081;12;5;0;17
064103;SPERONE;AV;3660;12;5;0;17
018152;SPESSA;PV;554;8;5;0;13
078142;SPEZZANO ALBANESE;CS;6636;10;7;0;17
078143;SPEZZANO DELLA SILA;CS;4283;13;4;0;17
022179;SPIAZZO;TN;1246;13;5;0;18
006165;SPIGNO MONFERRATO;AL;923;9;4;0;13
059031;SPIGNO SATURNIA;LT;2856;11;2;0;13
036045;SPILAMBERTO;MO;12865;11;10;0;21
093044;SPILIMBERGO;PN;11826;18;10;0;28
019100;SPINADESCO;CR;1476;7;6;0;13
027038;SPINEA;VE;27749;0;0;1;1
019101;SPINEDA;CR;600;8;5;0;13
070076;SPINETE;CB;1186;9;4;0;13
006166;SPINETO SCRIVIA;AL;367;10;3;0;13
044071;SPINETOLI;AP;7219;9;8;0;17
019102;SPINO D'ADDA;CR;6846;10;7;0;17
016205;SPINONE AL LAGO;BG;965;9;4;0;13
076086;SPINOSO;PZ;1355;11;2;0;13
016206;SPIRANO;BG;5609;11;6;0;17
054051;SPOLETO;PG;36467;20;12;0;32
068041;SPOLTORE;PE;18935;13;9;0;22
075078;SPONGANO;LE;3490;15;2;0;17
022180;SPORMAGGIORE;TN;1270;15;5;0;20
022181;SPORMINORE;TN;704;8;4;0;12
009057;SPOTORNO;SV;3498;8;9;0;17
026082;SPRESIANO;TV;12298;14;8;0;22
014062;SPRIANA;SO;79;6;5;0;11
079142;SQUILLACE;CZ;3543;12;4;0;16
075079;SQUINZANO;LE;13482;14;8;0;22
042049;STAFFOLO;AN;2087;8;5;0;13
019103;STAGNO LOMBARDO;CR;1429;11;2;0;13
080090;STAITI;RC;189;5;7;0;12
079143;STALETTI';CZ;2320;9;1;0;10
028088;STANGHELLA;PD;4138;8;8;0;16
031023;STARANZANO;GO;7246;16;7;0;23
073029;STATTE;TA;13136;14;8;0;22
006167;STAZZANO;AL;2337;8;5;0;13
046030;STAZZEMA;LU;2890;12;5;0;17
013218;STAZZONA;CO;613;9;4;0;13
009058;STELLA;SV;2937;14;3;0;17
065144;STELLA CILENTO;SA;685;13;0;0;13
009059;STELLANELLO;SV;852;7;6;0;13
021095;STELVIO;BZ;1139;13;7;0;20
022182;STENICO;TN;1158;13;7;0;20
075080;STERNATIA;LE;2179;10;1;0;11
016207;STEZZANO;BG;13339;13;9;0;22
029045;STIENTA;RO;3113;11;6;0;17
077027;STIGLIANO;MT;3667;13;3;0;16
080091;STIGNANO;RC;1231;12;1;0;13
080092;STILO;RC;2404;9;4;0;13
057066;STIMIGLIANO;RI;2203;11;2;0;13
090089;STINTINO;SS;1538;8;9;0;17
065145;STIO;SA;776;13;0;0;13
071054;STORNARA;FG;5707;9;8;0;17
071055;STORNARELLA;FG;5228;10;7;0;17
022183;STORO;TN;4523;17;7;0;24
027039;STRA;VE;7599;10;7;0;17
018153;STRADELLA;PV;11406;13;9;0;22
001268;STRAMBINELLO;TO;260;8;5;0;13
001269;STRAMBINO;TO;6080;12;5;0;17
060075;STRANGOLAGALLI;FR;2278;9;4;0;13
030111;STREGNA;UD;304;10;4;0;14
022184;STREMBO;TN;601;12;4;0;16
006168;STREVI;AL;1896;5;8;0;13
063081;STRIANO;NA;8709;9;8;0;17
096065;STRONA;BI;967;9;4;0;13
055031;STRONCONE;TR;4638;13;4;0;17
002142;STROPPIANA;VC;1172;7;6;0;13
004224;STROPPO;CN;96;7;6;0;13
016208;STROZZA;BG;1077;9;4;0;13
064104;STURNO;AV;2817;11;6;0;17
018154;SUARDI;PV;588;7;3;0;10
051037;SUBBIANO;AR;6274;10;7;0;17
058103;SUBIACO;RM;8538;8;9;0;17
061090;SUCCIVO;CE;8705;11;6;0;17
097077;SUEGLIO;LC;141;8;5;0;13
097078;SUELLO;LC;1765;9;4;0;13
016209;SUISIO;BG;3774;9;7;0;16
066098;SULMONA;AQ;22438;15;7;0;22
017182;SULZANO;BS;1944;7;6;0;13
012124;SUMIRAGO;VA;5974;9;8;0;17
064105;SUMMONTE;AV;1512;9;4;0;13
095087;SUNI;OR;994;12;5;0;17
003143;SUNO;NO;2706;10;3;0;13
075081;SUPERSANO;LE;4181;13;4;0;17
060076;SUPINO;FR;4665;14;3;0;17
075082;SURANO;LE;1542;12;1;0;13
075083;SURBO;LE;14695;14;8;0;22
001270;SUSA;TO;5940;10;7;0;17
026083;SUSEGANA;TV;11740;14;8;0;22
020064;SUSTINENTE;MN;2023;10;3;0;13
085020;SUTERA;CL;1209;7;8;0;15
056049;SUTRI;VT;6597;9;8;0;17
030112;SUTRIO;UD;1239;12;4;0;16
049020;SUVERETO;LI;2980;12;5;0;17
020065;SUZZARA;MN;20842;12;9;0;21
097079;TACENO;LC;539;9;4;0;13
095064;TADASUNI;OR;141;9;5;0;14
008059;TAGGIA;IM;13766;15;6;0;21
066099;TAGLIACOZZO;AQ;6449;11;6;0;17
029046;TAGLIO DI PO;RO;7970;11;6;0;17
006169;TAGLIOLO MONFERRATO;AL;1503;8;5;0;13
025059;TAIBON AGORDINO;BL;1720;10;3;0;13
012125;TAINO;VA;3621;12;5;0;17
030113;TAIPANA;UD;565;9;5;0;14
099027;TALAMELLO;RN;1067;9;4;0;13
014063;TALAMONA;SO;4623;10;7;0;17
091088;TALANA;NU;964;12;4;0;16
016210;TALEGGIO;BG;539;10;2;0;12
051038;TALLA;AR;975;7;6;0;13
030114;TALMASSONS;UD;3878;13;10;0;23
025060;TAMBRE;BL;1285;8;5;0;13
083097;TAORMINA;ME;10473;14;8;0;22
057067;TARANO;RI;1377;7;4;0;11
069089;TARANTA PELIGNA;CH;329;7;6;0;13
004225;TARANTASCA;CN;2166;8;5;0;13
073027;TARANTO;TA;189461;31;11;0;42
030116;TARCENTO;UD;8835;15;7;0;22
056050;TARQUINIA;VT;16075;15;7;0;22
078145;TARSIA;CS;1878;12;1;0;13
014064;TARTANO;SO;196;9;3;0;12
030117;TARVISIO;UD;3997;14;8;0;22
026084;TARZO;TV;4226;10;7;0;17
006170;TASSAROLO;AL;599;7;6;0;13
064106;TAURANO;AV;1486;13;0;0;13
064107;TAURASI;AV;2191;11;2;0;13
080093;TAURIANOVA;RC;14947;14;8;0;22
075084;TAURISANO;LE;11345;14;8;0;22
030118;TAVAGNACCO;UD;14730;19;9;0;28
001271;TAVAGNASCO;TO;745;11;2;0;13
098056;TAVAZZANO CON VILLAVESCO;LO;5897;11;6;0;17
070077;TAVENNA;CB;602;8;5;0;13
079146;TAVERNA;CZ;2529;10;3;0;13
013222;TAVERNERIO;CO;5700;9;8;0;17
016211;TAVERNOLA BERGAMASCA;BG;1961;10;3;0;13
017183;TAVERNOLE SUL MELLA;BS;1219;11;2;0;13
075085;TAVIANO;LE;11551;13;9;0;22
096066;TAVIGLIANO;BI;937;7;6;0;13
041064;TAVOLETO;PU;831;10;3;0;13
041065;TAVULLIA;PU;7883;9;8;0;17
076087;TEANA;PZ;533;10;3;0;13
061091;TEANO;CE;11448;15;7;0;22
065146;TEGGIANO;SA;7186;8;9;0;17
014065;TEGLIO;SO;4410;12;5;0;17
027040;TEGLIO VENETO;VE;2256;8;5;0;13
062074;TELESE TERME;BN;7645;9;8;0;17
016212;TELGATE;BG;4978;7;10;0;17
090080;TELTI;SS;2236;14;3;0;17
022188;TELVE;TN;1886;15;5;0;20
022189;TELVE DI SOPRA;TN;598;10;5;0;15
090070;TEMPIO PAUSANIA;SS;13329;13;9;0;22
017184;TEMU';BS;1105;12;1;0;13
022190;TENNA;TN;1048;11;5;0;16
022191;TENNO;TN;1984;11;9;0;20
028089;TEOLO;PD;8867;10;7;0;17
064108;TEORA;AV;1463;10;3;0;13
067041;TERAMO;TE;51849;1;0;0;1
003144;TERDOBBIATE;NO;459;8;4;0;12
060077;TERELLE;FR;312;8;5;0;13
021096;TERENTO;BZ;1779;13;6;0;19
034038;TERENZO;PR;1162;10;3;0;13
090086;TERGU;SS;606;7;7;0;14
021097;TERLANO;BZ;4749;19;4;0;23
072043;TERLIZZI;BA;26209;15;7;0;22
083106;TERME VIGLIATORE;ME;7216;10;7;0;17
021098;TERMENO SULLA STRADA DEL VINO;BZ;3396;18;5;0;23
082070;TERMINI IMERESE;PA;25082;16;6;0;22
070078;TERMOLI;CB;32391;23;7;0;30
012126;TERNATE;VA;2485;8;5;0;13
096067;TERNENGO;BI;260;9;4;0;13
016213;TERNO D'ISOLA;BG;8016;11;5;0;16
059032;TERRACINA;LT;44504;21;11;0;32
022193;TERRAGNOLO;TN;705;10;6;0;16
095065;TERRALBA;OR;9792;12;9;0;21
078146;TERRANOVA DA SIBARI;CS;4622;12;5;0;17
098057;TERRANOVA DEI PASSERINI;LO;931;8;3;0;11
076088;TERRANOVA DI POLLINO;PZ;1039;10;3;0;13
080094;TERRANOVA SAPPO MINULIO;RC;460;9;4;0;13
051039;TERRANUOVA BRACCIOLINI;AR;11983;13;9;0;22
082071;TERRASINI;PA;12706;13;9;0;22
028090;TERRASSA PADOVANA;PD;2677;10;3;0;13
078147;TERRAVECCHIA;CS;610;10;3;0;13
023085;TERRAZZO;VR;2140;8;5;0;13
022251;TERRE D'ADIGE;TN;3043;17;7;0;24
038028;TERRE DEL RENO;FE;9878;14;8;0;22
041070;TERRE ROVERESCHE;PU;5147;11;6;0;17
050036;TERRICCIOLA;PI;4460;10;7;0;17
006171;TERRUGGIA;AL;912;10;3;0;13
091089;TERTENIA;NU;3855;12;5;0;17
063082;TERZIGNO;NA;17256;16;6;0;22
006172;TERZO;AL;838;8;5;0;13
030120;TERZO D'AQUILEIA;UD;2729;8;9;0;17
022195;TERZOLAS;TN;636;8;7;0;15
008060;TERZORIO;IM;235;6;7;0;13
022196;TESERO;TN;2937;13;7;0;20
021099;TESIMO;BZ;1980;12;8;0;20
056051;TESSENNANO;VT;288;12;1;0;13
009060;TESTICO;SV;177;8;5;0;13
091090;TETI;NU;610;9;4;0;13
061092;TEVEROLA;CE;14651;0;0;1;1
024104;TEZZE SUL BRENTA;VI;12891;13;9;0;22
024105;THIENE;VI;23945;16;6;0;22
090071;THIESI;SS;2814;8;9;0;17
091091;TIANA;NU;444;7;7;0;14
019104;TICENGO;CR;417;9;4;0;13
006173;TICINETO;AL;1307;9;4;0;13
075086;TIGGIANO;LE;2753;12;1;0;13
010061;TIGLIETO;GE;476;9;4;0;13
005108;TIGLIOLE;AT;1703;11;2;0;13
017185;TIGNALE;BS;1158;9;4;0;13
095088;TINNURA;OR;239;9;4;0;13
066100;TIONE DEGLI ABRUZZI;AQ;267;9;4;0;13
022199;TIONE DI TRENTO;TN;3652;19;5;0;24
014066;TIRANO;SO;8823;9;8;0;17
021100;TIRES;BZ;999;10;7;0;17
079147;TIRIOLO;CZ;3605;13;4;0;17
021101;TIROLO;BZ;2462;16;4;0;20
090072;TISSI;SS;2361;13;4;0;17
076089;TITO;PZ;7147;9;8;0;17
058104;TIVOLI;RM;55176;20;12;0;32
034039;TIZZANO VAL PARMA;PR;2120;9;4;0;13
035041;TOANO;RE;4123;15;2;0;17
062075;TOCCO CAUDIO;BN;1440;13;0;0;13
068042;TOCCO DA CASAURIA;PE;2422;11;2;0;13
054052;TODI;PG;15789;16;6;0;22
057068;TOFFIA;RI;1089;8;5;0;13
009061;TOIRANO;SV;2640;8;5;0;13
043053;TOLENTINO;MC;18142;13;9;0;22
058105;TOLFA;RM;4789;10;6;0;16
096068;TOLLEGNO;BI;2383;9;2;0;11
069090;TOLLO;CH;3928;11;6;0;17
030121;TOLMEZZO;UD;9891;19;9;0;28
076090;TOLVE;PZ;2990;17;0;0;17
028091;TOMBOLO;PD;8240;10;7;0;17
022200;TON;TN;1312;12;7;0;19
091093;TONARA;NU;1812;12;5;0;17
005109;TONCO;AT;774;7;5;0;12
024106;TONEZZA DEL CIMONE;VI;501;11;2;0;13
061093;TORA E PICCILLI;CE;792;7;6;0;13
078148;TORANO CASTELLO;CS;4343;13;4;0;17
067042;TORANO NUOVO;TE;1490;7;6;0;13
017186;TORBOLE CASAGLIA;BS;6401;9;8;0;17
022202;TORCEGNO;TN;684;10;6;0;16
065147;TORCHIARA;SA;1824;12;1;0;13
074018;TORCHIAROLO;BR;5241;9;8;0;17
064109;TORELLA DEI LOMBARDI;AV;1970;8;5;0;13
070079;TORELLA DEL SANNIO;CB;704;6;7;0;13
054053;TORGIANO;PG;6640;10;7;0;17
007067;TORGNON;AO;556;9;3;0;12
001272;TORINO;TO;848748;30;22;0;52
069091;TORINO DI SANGRO;CH;2945;11;2;0;13
072044;TORITTO;BA;8061;9;8;0;17
019105;TORLINO VIMERCATI;CR;480;9;4;0;13
003146;TORNACO;NO;875;7;6;0;13
069092;TORNARECCIO;CH;1663;12;1;0;13
019106;TORNATA;CR;426;10;3;0;13
066101;TORNIMPARTE;AQ;2847;11;6;0;17
013223;TORNO;CO;1106;9;4;0;13
034040;TORNOLO;PR;915;12;1;0;13
070080;TORO;CB;1243;11;2;0;13
091094;TORPE';NU;2720;13;4;0;17
065148;TORRACA;SA;1185;11;2;0;13
090073;TORRALBA;SS;904;7;7;0;14
018155;TORRAZZA COSTE;PV;1569;5;8;0;13
001273;TORRAZZA PIEMONTE;TO;3000;7;6;0;13
096069;TORRAZZO;BI;205;10;3;0;13
063083;TORRE ANNUNZIATA;NA;40523;0;0;3;3
018156;TORRE BERETTI E CASTELLARO;PV;507;4;9;0;13
016214;TORRE BOLDONE;BG;8620;10;7;0;17
004226;TORRE BORMIDA;CN;162;11;2;0;13
060078;TORRE CAJETANI;FR;1315;12;1;0;13
001274;TORRE CANAVESE;TO;620;8;5;0;13
018157;TORRE D'ARESE;PV;929;9;4;0;13
018159;TORRE D'ISOLA;PV;2387;7;6;0;13
016215;TORRE DE' BUSI;BG;2183;7;6;0;13
018158;TORRE DE' NEGRI;PV;313;10;3;0;13
068043;TORRE DE' PASSERI;PE;2883;10;7;0;17
019107;TORRE DE' PICENARDI;CR;2103;9;4;0;13
016216;TORRE DE' ROVERI;BG;2526;9;4;0;13
063084;TORRE DEL GRECO;NA;81289;21;11;0;32
027041;TORRE DI MOSTO;VE;4766;13;4;0;17
079148;TORRE DI RUGGIERO;CZ;961;11;2;0;13
014067;TORRE DI SANTA MARIA;SO;745;7;5;0;12
064110;TORRE LE NOCELLE;AV;1202;9;4;0;13
004227;TORRE MONDOVI';CN;489;8;5;0;13
065149;TORRE ORSAIA;SA;1982;9;4;0;13
016217;TORRE PALLAVICINA;BG;1127;9;4;0;13
001275;TORRE PELLICE;TO;4591;9;8;0;17
004228;TORRE SAN GIORGIO;CN;744;9;4;0;13
074019;TORRE SANTA SUSANNA;BR;10151;11;11;0;22
030122;TORREANO;UD;2068;9;8;0;17
024107;TORREBELVICINO;VI;5817;11;6;0;17
069093;TORREBRUNA;CH;717;9;4;0;13
062076;TORRECUSO;BN;3260;12;5;0;17
028092;TORREGLIA;PD;6110;10;7;0;17
083098;TORREGROTTA;ME;7268;12;5;0;17
071056;TORREMAGGIORE;FG;16567;12;10;0;22
083108;TORRENOVA;ME;4484;9;8;0;17
004229;TORRESINA;CN;48;11;2;0;13
082072;TORRETTA;PA;4201;10;6;0;16
018160;TORREVECCHIA PIA;PV;3480;11;6;0;17
069094;TORREVECCHIA TEATINA;CH;4206;12;5;0;17
023086;TORRI DEL BENACO;VR;2967;9;4;0;13
024108;TORRI DI QUARTESOLO;VI;11738;14;8;0;22
057070;TORRI IN SABINA;RI;1221;8;3;0;11
060079;TORRICE;FR;4733;15;2;0;17
073028;TORRICELLA;TA;4165;14;3;0;17
019108;TORRICELLA DEL PIZZO;CR;574;0;0;1;1
057069;TORRICELLA IN SABINA;RI;1333;9;4;0;13
069095;TORRICELLA PELIGNA;CH;1152;7;5;0;12
067043;TORRICELLA SICURA;TE;2460;9;4;0;13
018161;TORRICELLA VERZATE;PV;816;8;5;0;13
010062;TORRIGLIA;GE;2195;10;3;0;13
034041;TORRILE;PR;7686;7;10;0;17
064111;TORRIONI;AV;456;9;4;0;13
052035;TORRITA DI SIENA;SI;7014;10;7;0;17
058106;TORRITA TIBERINA;RM;1079;5;8;0;13
091095;TORTOLI';NU;11024;13;9;0;22
006174;TORTONA;AL;26461;17;5;0;22
078149;TORTORA;CS;5949;10;7;0;17
065150;TORTORELLA;SA;473;13;0;0;13
067044;TORTORETO;TE;11846;12;10;0;22
083099;TORTORICI;ME;5792;11;7;0;18
030123;TORVISCOSA;UD;2648;9;8;0;17
017187;TOSCOLANO MADERNO;BS;7550;10;7;0;17
067045;TOSSICIA;TE;1258;6;6;0;12
014068;TOVO DI SANT'AGATA;SO;626;8;4;0;12
009062;TOVO SAN GIACOMO;SV;2504;9;4;0;13
082073;TRABIA;PA;10505;15;7;0;22
012127;TRADATE;VA;18834;16;6;0;22
095066;TRAMATZA;OR;937;4;10;0;14
022203;TRAMBILENO;TN;1467;16;4;0;20
065151;TRAMONTI;SA;4092;13;4;0;17
093045;TRAMONTI DI SOPRA;PN;271;9;4;0;13
093046;TRAMONTI DI SOTTO;PN;339;8;6;0;14
076091;TRAMUTOLA;PZ;2941;9;8;0;17
001276;TRANA;TO;3813;10;7;0;17
014069;TRAONA;SO;2842;8;5;0;13
081021;TRAPANI;TP;56293;22;8;0;30
082074;TRAPPETO;PA;3055;11;6;0;17
066102;TRASACCO;AQ;5897;10;7;0;17
030124;TRASAGHIS;UD;2099;10;7;0;17
018162;TRAVACO' SICCOMARIO;PV;4402;12;5;0;17
017188;TRAVAGLIATO;BS;13725;11;11;0;22
012128;TRAVEDONA-MONATE;VA;3949;10;7;0;17
001278;TRAVERSELLA;TO;319;8;5;0;13
034042;TRAVERSETOLO;PR;9454;9;8;0;17
001279;TRAVES;TO;486;11;1;0;12
093047;TRAVESIO;PN;1783;10;5;0;15
033043;TRAVO;PC;2165;10;3;0;13
022247;TRE VILLE;TN;1365;14;5;0;19
028093;TREBASELEGHE;PD;12889;13;9;0;22
078150;TREBISACCE;CS;8593;10;7;0;17
063091;TRECASE;NA;8594;10;7;0;17
087050;TRECASTAGNI;CT;11230;13;9;0;22
042050;TRECASTELLI;AN;7442;11;6;0;17
003149;TRECATE;NO;20496;15;7;0;22
076092;TRECCHINA;PZ;2182;9;4;0;13
029047;TRECENTA;RO;2591;6;7;0;13
040049;TREDOZIO;FC;1121;10;3;0;13
069096;TREGLIO;CH;1730;8;5;0;13
023087;TREGNAGO;VR;4969;13;4;0;17
043054;TREIA;MC;9093;9;8;0;17
004230;TREISO;CN;761;9;4;0;13
087051;TREMESTIERI ETNEO;CT;19851;13;9;0;22
013252;TREMEZZINA;CO;5027;11;6;0;17
017189;TREMOSINE SUL GARDA;BS;2046;10;3;0;13
065152;TRENTINARA;SA;1572;11;2;0;13
022205;TRENTO;TN;117847;34;14;0;48
061094;TRENTOLA DUCENTA;CE;20137;16;6;0;22
017190;TRENZANO;BS;5470;9;8;0;17
030126;TREPPO GRANDE;UD;1699;8;9;0;17
030191;TREPPO LIGOSULLO;UD;682;10;5;0;15
075087;TREPUZZI;LE;14099;12;10;0;22
052036;TREQUANDA;SI;1195;7;6;0;13
045015;TRESANA;MS;1952;7;6;0;13
016218;TRESCORE BALNEARIO;BG;9711;9;8;0;17
019109;TRESCORE CREMASCO;CR;2794;8;5;0;13
038030;TRESIGNANA;FE;6951;10;7;0;17
014070;TRESIVIO;SO;2011;9;4;0;13
095067;TRESNURAGHES;OR;1051;7;10;0;17
023088;TREVENZUOLO;VR;2757;9;4;0;13
054054;TREVI;PG;8127;11;6;0;17
060080;TREVI NEL LAZIO;FR;1749;11;2;0;13
064112;TREVICO;AV;867;11;2;0;13
016219;TREVIGLIO;BG;30567;13;9;0;22
026085;TREVIGNANO;TV;10722;10;12;0;22
058107;TREVIGNANO ROMANO;RM;5832;7;10;0;17
006175;TREVILLE;AL;258;7;6;0;13
016220;TREVIOLO;BG;10857;12;10;0;22
026086;TREVISO;TV;84452;26;14;0;40
017191;TREVISO BRESCIANO;BS;507;8;4;0;12
015219;TREZZANO ROSA;MI;5374;8;7;0;15
015220;TREZZANO SUL NAVIGLIO;MI;21460;15;7;0;22
015221;TREZZO SULL'ADDA;MI;11930;13;9;0;22
004231;TREZZO TINELLA;CN;303;8;5;0;13
013226;TREZZONE;CO;237;8;5;0;13
028094;TRIBANO;PD;4247;13;4;0;17
015222;TRIBIANO;MI;3672;9;8;0;17
010063;TRIBOGNA;GE;566;11;2;0;13
077028;TRICARICO;MT;4857;12;5;0;17
075088;TRICASE;LE;17142;17;5;0;22
002147;TRICERRO;VC;680;9;4;0;13
030127;TRICESIMO;UD;7596;14;9;0;23
091097;TRIEI;NU;1071;11;4;0;15
032006;TRIESTE;TS;199015;35;16;0;51
072046;TRIGGIANO;BA;26113;15;7;0;22
019110;TRIGOLO;CR;1638;7;5;0;12
004232;TRINITA';CN;2231;10;3;0;13
090074;TRINITA' D'AGULTU E VIGNOLA;SS;2239;11;6;0;17
002148;TRINO;VC;6692;11;6;0;17
008061;TRIORA;IM;360;12;1;0;13
083100;TRIPI;ME;755;9;6;0;15
006176;TRISOBBIO;AL;667;10;3;0;13
024110;TRISSINO;VI;8638;11;5;0;16
070081;TRIVENTO;CB;4437;12;5;0;17
060081;TRIVIGLIANO;FR;1631;10;3;0;13
030128;TRIVIGNANO UDINESE;UD;1564;9;8;0;17
076093;TRIVIGNO;PZ;588;8;5;0;13
018163;TRIVOLZIO;PV;2364;8;4;0;12
021102;TRODENA NEL PARCO NATURALE;BZ;1045;12;8;0;20
001280;TROFARELLO;TO;10580;15;7;0;22
071058;TROIA;FG;6771;11;6;0;17
086018;TROINA;EN;8642;11;7;0;18
018164;TROMELLO;PV;3647;14;3;0;17
012129;TRONZANO LAGO MAGGIORE;VA;225;9;4;0;13
002150;TRONZANO VERCELLESE;VC;3318;10;6;0;16
018165;TROVO;PV;1017;7;5;0;12
015224;TRUCCAZZANO;MI;5844;9;8;0;17
021103;TUBRE;BZ;962;10;6;0;16
070082;TUFARA;CB;798;12;1;0;13
069097;TUFILLO;CH;357;9;4;0;13
063085;TUFINO;NA;3427;10;7;0;17
064113;TUFO;AV;795;8;5;0;13
075089;TUGLIE;LE;5067;9;8;0;17
090075;TULA;SS;1466;7;10;0;17
054055;TUORO SUL TRASIMENO;PG;3743;13;4;0;17
057071;TURANIA;RI;223;12;1;0;13
098058;TURANO LODIGIANO;LO;1500;7;6;0;13
013227;TURATE;CO;9555;11;6;0;17
015226;TURBIGO;MI;7046;9;8;0;17
072047;TURI;BA;12928;14;8;0;22
031024;TURRIACO;GO;2806;10;6;0;16
068044;TURRIVALIGNANI;PE;790;11;2;0;13
077029;TURSI;MT;4753;10;7;0;17
083101;TUSA;ME;2638;9;6;0;15
056052;TUSCANIA;VT;8242;9;8;0;17
016221;UBIALE CLANEZZO;BG;1353;6;7;0;13
012130;UBOLDO;VA;10719;14;8;0;22
083102;UCRIA;ME;924;9;6;0;15
030129;UDINE;UD;97736;31;20;0;51
075090;UGENTO;LE;12075;13;9;0;22
075091;UGGIANO LA CHIESA;LE;4347;14;3;0;17
013228;UGGIATE-TREVANO;CO;5037;8;8;0;16
095068;ULA TIRSO;OR;475;9;3;0;12
091098;ULASSAI;NU;1369;11;6;0;17
021104;ULTIMO;BZ;2897;15;4;0;19
054056;UMBERTIDE;PG;16358;17;5;0;22
017192;URAGO D'OGLIO;BS;3733;11;6;0;17
095069;URAS;OR;2697;12;5;0;17
028095;URBANA;PD;2044;8;5;0;13
041066;URBANIA;PU;6888;8;9;0;17
009063;URBE;SV;653;8;5;0;13
041067;URBINO;PU;13772;14;8;0;22
043055;URBISAGLIA;MC;2439;6;7;0;13
016222;URGNANO;BG;9821;10;7;0;17
090076;URI;SS;2856;12;5;0;17
070083;URURI;CB;2470;11;2;0;13
091099;URZULEI;NU;1125;11;6;0;17
010064;USCIO;GE;2141;10;3;0;13
095070;USELLUS;OR;727;12;2;0;14
090077;USINI;SS;4237;9;6;0;15
091100;USSASSAI;NU;473;11;3;0;14
001281;USSEAUX;TO;178;7;6;0;13
001282;USSEGLIO;TO;195;10;3;0;13
043056;USSITA;MC;378;7;6;0;13
082075;USTICA;PA;1307;7;7;0;14
092090;UTA;CA;8671;11;11;0;22
047021;UZZANO;PT;5609;10;7;0;17
078152;VACCARIZZO ALBANESE;CS;1029;12;1;0;13
057072;VACONE;RI;226;10;3;0;13
069098;VACRI;CH;1526;8;5;0;13
021105;VADENA;BZ;1076;13;7;0;20
009064;VADO LIGURE;SV;8105;0;0;1;1
046031;VAGLI SOTTO;LU;839;11;2;0;13
048046;VAGLIA;FI;5208;9;8;0;17
076094;VAGLIO BASILICATA;PZ;1880;10;3;0;13
005111;VAGLIO SERRA;AT;276;12;1;0;13
019111;VAIANO CREMASCO;CR;3554;13;4;0;17
001283;VAIE;TO;1389;8;5;0;13
019112;VAILATE;CR;4600;12;5;0;17
061095;VAIRANO PATENORA;CE;6307;10;7;0;17
093052;VAJONT;PN;1669;10;7;0;17
016253;VAL BREMBILLA;BG;4156;12;5;0;17
001284;VAL DELLA TORRE;TO;3982;9;8;0;17
001317;VAL DI CHY;TO;1235;11;2;0;13
018166;VAL DI NIZZA;PV;579;9;4;0;13
021107;VAL DI VIZZE;BZ;3065;12;8;0;20
025073;VAL DI ZOLDO;BL;2817;9;6;0;15
024123;VAL LIONA;VI;3060;11;6;0;17
014074;VAL MASINO;SO;841;9;4;0;13
013233;VAL REZZO;CO;162;11;2;0;13
016223;VALBONDIONE;BG;968;9;4;0;13
016224;VALBREMBO;BG;4352;12;5;0;17
024125;VALBRENTA;VI;4870;9;8;0;17
010065;VALBREVENNA;GE;757;12;1;0;13
013229;VALBRONA;CO;2625;9;4;0;13
001318;VALCHIUSA;TO;1003;11;1;0;12
024111;VALDAGNO;VI;25697;15;7;0;22
022232;VALDAONE;TN;1149;16;3;0;19
021106;VALDAORA;BZ;3166;18;5;0;23
024112;VALDASTICO;VI;1175;9;5;0;14
096071;VALDENGO;BI;2396;9;4;0;13
081022;VALDERICE;TP;11551;14;8;0;22
014071;VALDIDENTRO;SO;4134;12;4;0;16
004233;VALDIERI;CN;912;10;3;0;13
096088;VALDILANA;BI;10235;15;7;0;22
083103;VALDINA;ME;1268;9;6;0;15
014072;VALDISOTTO;SO;3594;12;5;0;17
026087;VALDOBBIADENE;TV;10002;11;11;0;22
002152;VALDUGGIA;VC;1875;11;2;0;13
018167;VALEGGIO;PV;195;12;1;0;13
023089;VALEGGIO SUL MINCIO;VR;15857;11;11;0;22
056053;VALENTANO;VT;2762;9;4;0;13
006177;VALENZA;AL;18090;14;8;0;22
072048;VALENZANO;BA;17457;15;7;0;22
098059;VALERA FRATTA;LO;1730;9;4;0;13
054057;VALFABBRICA;PG;3246;11;6;0;17
005112;VALFENERA;AT;2416;7;6;0;13
022209;VALFLORIANA;TN;474;11;4;0;15
043058;VALFORNACE;MC;921;9;4;0;13
014073;VALFURVA;SO;2498;10;2;0;12
012131;VALGANNA;VA;1595;7;6;0;13
001285;VALGIOIE;TO;976;10;3;0;13
016225;VALGOGLIO;BG;585;11;2;0;13
004234;VALGRANA;CN;808;10;3;0;13
097082;VALGREGHENTINO;LC;3405;7;10;0;17
007068;VALGRISENCHE;AO;192;9;4;0;13
086019;VALGUARNERA CAROPEPE;EN;7082;11;6;0;17
025062;VALLADA AGORDINA;BL;466;12;1;0;13
096072;VALLANZENGO;BI;206;9;4;0;13
022210;VALLARSA;TN;1383;11;9;0;20
064114;VALLATA;AV;2540;11;2;0;13
061096;VALLE AGRICOLA;CE;766;9;4;0;13
021108;VALLE AURINA;BZ;5989;16;7;0;23
067046;VALLE CASTELLANA;TE;880;11;2;0;13
065153;VALLE DELL'ANGELO;SA;220;7;6;0;13
025063;VALLE DI CADORE;BL;1862;10;3;0;13
021109;VALLE DI CASIES;BZ;2339;13;6;0;19
061097;VALLE DI MADDALONI;CE;2643;13;0;0;13
018168;VALLE LOMELLINA;PV;2066;9;4;0;13
018169;VALLE SALIMBENE;PV;1451;9;4;0;13
096074;VALLE SAN NICOLAO;BI;881;6;7;0;13
008062;VALLEBONA;IM;1257;8;5;0;13
060082;VALLECORSA;FR;2438;8;5;0;13
008063;VALLECROSIA;IM;6727;12;5;0;17
082076;VALLEDOLMO;PA;3227;9;8;0;17
090079;VALLEDORIA;SS;4264;14;3;0;17
079151;VALLEFIORITA;CZ;1531;11;2;0;13
041068;VALLEFOGLIA;PU;14917;14;8;0;22
022248;VALLELAGHI;TN;5176;17;6;0;23
085021;VALLELUNGA PRATAMENO;CL;3164;10;7;0;17
060083;VALLEMAIO;FR;892;10;3;0;13
058108;VALLEPIETRA;RM;248;11;2;0;13
056054;VALLERANO;VT;2442;9;4;0;13
060084;VALLEROTONDA;FR;1414;11;2;0;13
064115;VALLESACCARDA;AV;1250;10;3;0;13
016226;VALLEVE;BG;127;8;2;0;10
024113;VALLI DEL PASUBIO;VI;3064;14;3;0;17
058109;VALLINFREDA;RM;298;10;3;0;13
017193;VALLIO TERME;BS;1410;8;4;0;12
065154;VALLO DELLA LUCANIA;SA;8084;9;8;0;17
054058;VALLO DI NERA;PG;340;6;7;0;13
001286;VALLO TORINESE;TO;780;10;3;0;13
004235;VALLORIATE;CN;99;7;5;0;12
006178;VALMACCA;AL;966;7;5;0;12
097083;VALMADRERA;LC;11161;14;8;0;22
058110;VALMONTONE;RM;15698;11;11;0;22
013232;VALMOREA;CO;2583;8;5;0;13
034044;VALMOZZOLA;PR;530;9;4;0;13
016227;VALNEGRA;BG;215;7;6;0;13
007069;VALPELLINE;AO;591;11;5;0;16
001287;VALPERGA;TO;2974;11;6;0;17
001288;VALPRATO SOANA;TO;90;10;3;0;13
037061;VALSAMOGGIA;BO;31605;11;11;0;22
007070;VALSAVARENCHE;AO;166;11;3;0;14
077030;VALSINNI;MT;1373;8;5;0;13
013234;VALSOLDA;CO;1426;11;2;0;13
054059;VALTOPINA;PG;1271;9;4;0;13
016229;VALTORTA;BG;249;9;1;0;10
007071;VALTOURNENCHE;AO;2198;14;5;0;19
065155;VALVA;SA;1551;13;0;0;13
097093;VALVARRONE;LC;508;10;3;0;13
093053;VALVASONE ARZENE;PN;3917;14;9;0;23
087052;VALVERDE;CT;7838;13;4;0;17
017194;VALVESTINO;BS;173;12;1;0;13
021110;VANDOIES;BZ;3308;18;5;0;23
015249;VANZAGHELLO;MI;5262;11;6;0;17
015229;VANZAGO;MI;9327;8;9;0;17
015230;VAPRIO D'ADDA;MI;9462;11;6;0;17
003153;VAPRIO D'AGOGNA;NO;967;7;6;0;13
002156;VARALLO;VC;6926;10;7;0;17
003154;VARALLO POMBIA;NO;4946;9;8;0;17
012132;VARANO BORGHI;VA;2455;9;4;0;13
034045;VARANO DE' MELEGARI;PR;2592;10;3;0;13
080095;VARAPODIO;RC;1997;10;3;0;13
009065;VARAZZE;SV;12620;11;11;0;22
057073;VARCO SABINO;RI;165;12;1;0;13
097084;VARENNA;LC;725;6;7;0;13
012133;VARESE;VA;78740;30;12;0;42
011029;VARESE LIGURE;SP;1811;11;2;0;13
001289;VARISELLA;TO;850;10;3;0;13
030130;VARMO;UD;2642;11;6;0;17
021111;VARNA;BZ;4894;18;6;0;24
034046;VARSI;PR;1138;11;2;0;13
018171;VARZI;PV;3013;13;4;0;17
056055;VASANELLO;VT;3979;12;5;0;17
008064;VASIA;IM;366;9;4;0;13
069099;VASTO;CH;40565;20;12;0;32
094051;VASTOGIRARDI;IS;634;11;2;0;13
001290;VAUDA CANAVESE;TO;1435;9;4;0;13
026088;VAZZOLA;TV;6746;7;10;0;17
050037;VECCHIANO;PI;11910;12;10;0;22
012134;VEDANO OLONA;VA;7281;10;7;0;17
026089;VEDELAGO;TV;16554;13;9;0;22
016230;VEDESETA;BG;187;11;2;0;13
028096;VEGGIANO;PD;4802;11;6;0;17
075092;VEGLIE;LE;13421;12;10;0;22
096075;VEGLIO;BI;454;7;6;0;13
056056;VEJANO;VT;2154;9;4;0;13
013236;VELESO;CO;203;9;4;0;13
018172;VELEZZO LOMELLINA;PV;96;9;4;0;13
058111;VELLETRI;RM;52472;20;12;0;32
018173;VELLEZZO BELLINI;PV;3344;10;5;0;15
024115;VELO D'ASTICO;VI;2244;9;4;0;13
023090;VELO VERONESE;VR;771;11;2;0;13
021116;VELTURNO;BZ;3049;14;6;0;20
094052;VENAFRO;IS;11006;12;10;0;22
001292;VENARIA REALE;TO;32462;22;10;0;32
044073;VENAROTTA;AP;1914;7;6;0;13
004237;VENASCA;CN;1348;10;3;0;13
001291;VENAUS;TO;871;9;4;0;13
009066;VENDONE;SV;366;10;3;0;13
012136;VENEGONO INFERIORE;VA;5952;11;6;0;17
012137;VENEGONO SUPERIORE;VA;7257;11;6;0;17
083104;VENETICO;ME;3918;9;8;0;17
027042;VENEZIA;VE;251944;31;16;0;47
013238;VENIANO;CO;3078;10;3;0;13
076095;VENOSA;PZ;11035;9;13;0;22
035046;VENTASSO;RE;3964;14;3;0;17
064116;VENTICANO;AV;2289;11;2;0;13
008065;VENTIMIGLIA;IM;23018;15;7;0;22
082077;VENTIMIGLIA DI SICILIA;PA;1851;8;6;0;14
059033;VENTOTENE;LT;704;11;2;0;13
030131;VENZONE;UD;1953;9;6;0;15
021112;VERANO;BZ;985;11;6;0;17
078153;VERBICARO;CS;2674;10;7;0;17
013239;VERCANA;CO;743;7;6;0;13
014075;VERCEIA;SO;1063;8;5;0;13
002158;VERCELLI;VC;45176;30;12;0;42
097086;VERCURAGO;LC;2734;11;2;0;13
016232;VERDELLINO;BG;7509;10;7;0;17
016233;VERDELLO;BG;8118;9;8;0;17
097091;VERDERIO;LC;5508;9;7;0;16
004238;VERDUNO;CN;562;8;5;0;13
037059;VERGATO;BO;7521;11;6;0;17
040050;VERGHERETO;FC;1763;11;2;0;13
012138;VERGIATE;VA;8652;8;9;0;17
015251;VERMEZZO CON ZELO;MI;5831;10;7;0;17
022213;VERMIGLIO;TN;1795;14;5;0;19
004239;VERNANTE;CN;1104;10;3;0;13
033044;VERNASCA;PC;2000;12;1;0;13
015236;VERNATE;MI;3332;7;10;0;17
011030;VERNAZZA;SP;759;12;1;0;13
075093;VERNOLE;LE;6774;11;6;0;17
017195;VEROLANUOVA;BS;8018;7;10;0;17
017196;VEROLAVECCHIA;BS;3754;14;3;0;17
001293;VEROLENGO;TO;4782;12;5;0;17
060085;VEROLI;FR;19849;15;7;0;22
023091;VERONA;VR;255985;29;18;0;47
023092;VERONELLA;VR;5140;9;4;0;13
007072;VERRAYES;AO;1294;8;9;0;17
018174;VERRETTO;PV;377;10;2;0;12
096076;VERRONE;BI;1177;9;4;0;13
018175;VERRUA PO;PV;1187;10;3;0;13
001294;VERRUA SAVOIA;TO;1341;4;9;0;13
007073;VERRÈS;AO;2578;13;5;0;18
013242;VERTEMATE CON MINOPRIO;CO;4118;11;6;0;17
016234;VERTOVA;BG;4443;12;4;0;16
099020;VERUCCHIO;RN;10045;8;9;0;17
014076;VERVIO;SO;202;10;3;0;13
030132;VERZEGNIS;UD;838;8;5;0;13
004240;VERZUOLO;CN;6417;11;6;0;17
028097;VESCOVANA;PD;1720;8;5;0;13
019113;VESCOVATO;CR;3817;7;10;0;17
005113;VESIME;AT;592;7;5;0;12
003158;VESPOLATE;NO;2015;8;5;0;13
008066;VESSALICO;IM;247;6;7;0;13
023093;VESTENANOVA;VR;2498;9;4;0;13
001295;VESTIGNE';TO;753;9;4;0;13
017197;VESTONE;BS;4181;9;8;0;17
056057;VETRALLA;VT;13384;13;9;0;22
035042;VETTO;RE;1784;7;6;0;13
004241;VEZZA D'ALBA;CN;2352;9;4;0;13
017198;VEZZA D'OGLIO;BS;1473;11;2;0;13
011031;VEZZANO LIGURE;SP;7212;9;8;0;17
035043;VEZZANO SUL CROSTOLO;RE;4298;12;5;0;17
009067;VEZZI PORTIO;SV;795;8;4;0;12
020066;VIADANA;MN;19781;12;10;0;22
016235;VIADANICA;BG;1123;9;4;0;13
087053;VIAGRANDE;CT;8789;12;6;0;18
005114;VIALE;AT;250;12;1;0;13
001296;VIALFRE';TO;257;9;4;0;13
035044;VIANO;RE;3338;10;8;0;18
046033;VIAREGGIO;LU;61045;19;13;0;32
005115;VIARIGI;AT;868;1;12;0;13
065156;VIBONATI;SA;3215;14;3;0;17
060086;VICALVI;FR;743;10;3;0;13
082078;VICARI;PA;2461;9;6;0;15
048049;VICCHIO;FI;8022;9;8;0;17
024116;VICENZA;VI;110293;27;15;0;42
071059;VICO DEL GARGANO;FG;7353;9;8;0;17
063086;VICO EQUENSE;NA;20363;17;5;0;22
060087;VICO NEL LAZIO;FR;2072;10;3;0;13
004242;VICOFORTE;CN;3168;13;4;0;17
068045;VICOLI;PE;381;11;2;0;13
003159;VICOLUNGO;NO;826;9;4;0;13
050038;VICOPISANO;PI;8553;11;5;0;16
058112;VICOVARO;RM;3624;12;5;0;17
090082;VIDDALBA;SS;1623;14;3;0;17
018176;VIDIGULFO;PV;6555;10;7;0;17
026090;VIDOR;TV;3690;10;7;0;17
001298;VIDRACCO;TO;482;8;5;0;13
071060;VIESTE;FG;13434;14;8;0;22
076096;VIETRI DI POTENZA;PZ;2683;10;3;0;13
065157;VIETRI SUL MARE;SA;7318;10;7;0;17
016236;VIGANO SAN MARTINO;BG;1322;9;4;0;13
097090;VIGANO';LC;2093;9;4;0;13
038022;VIGARANO MAINARDA;FE;7571;10;6;0;16
023094;VIGASIO;VR;10220;10;7;0;17
018177;VIGEVANO;PV;62201;18;14;0;32
076097;VIGGIANELLO;PZ;2758;13;4;0;17
076098;VIGGIANO;PZ;3284;12;5;0;17
012139;VIGGIU';VA;5167;9;8;0;17
028098;VIGHIZZOLO D'ESTE;PD;897;10;3;0;13
096077;VIGLIANO BIELLESE;BI;7596;6;7;0;13
005116;VIGLIANO D'ASTI;AT;816;7;5;0;12
006179;VIGNALE MONFERRATO;AL;943;10;3;0;13
056058;VIGNANELLO;VT;4299;10;7;0;17
015237;VIGNATE;MI;9253;10;7;0;17
036046;VIGNOLA;MO;25686;12;10;0;22
022216;VIGNOLA-FALESINA;TN;181;14;2;0;16
006180;VIGNOLE BORBERA;AL;2022;9;4;0;13
004243;VIGNOLO;CN;2643;10;3;0;13
025065;VIGO DI CADORE;BL;1358;9;4;0;13
028099;VIGODARZERE;PD;13104;12;10;0;22
016237;VIGOLO;BG;577;9;3;0;12
033045;VIGOLZONE;PC;4218;12;5;0;17
001299;VIGONE;TO;5086;8;9;0;17
027043;VIGONOVO;VE;9890;10;7;0;17
028100;VIGONZA;PD;23082;16;6;0;22
006181;VIGUZZOLO;AL;3054;11;6;0;17
023095;VILLA BARTOLOMEA;VR;5782;9;8;0;17
046034;VILLA BASILICA;LU;1491;9;4;0;13
018178;VILLA BISCOSSI;PV;61;12;1;0;13
017199;VILLA CARCINA;BS;10694;14;7;0;21
074020;VILLA CASTELLI;BR;9079;8;9;0;17
068046;VILLA CELIERA;PE;556;12;1;0;13
046035;VILLA COLLEMANDINA;LU;1215;8;5;0;13
015248;VILLA CORTESE;MI;6175;9;8;0;17
016238;VILLA D'ADDA;BG;4575;7;8;0;15
016239;VILLA D'ALME';BG;6573;9;8;0;17
016241;VILLA D'OGNA;BG;1782;9;4;0;13
096078;VILLA DEL BOSCO;BI;316;7;6;0;13
028101;VILLA DEL CONTE;PD;5562;10;7;0;17
061098;VILLA DI BRIANO;CE;7308;9;8;0;17
014077;VILLA DI CHIAVENNA;SO;967;10;3;0;13
016240;VILLA DI SERIO;BG;6630;10;7;0;17
014078;VILLA DI TIRANO;SO;2996;6;7;0;13
028102;VILLA ESTENSE;PD;2105;6;7;0;13
008067;VILLA FARALDI;IM;448;7;6;0;13
013245;VILLA GUARDIA;CO;7877;11;6;0;17
022222;VILLA LAGARINA;TN;3881;14;9;0;23
060088;VILLA LATINA;FR;1156;9;4;0;13
061099;VILLA LITERNO;CE;12331;13;9;0;22
035045;VILLA MINOZZO;RE;3517;12;5;0;17
080096;VILLA SAN GIOVANNI;RC;12920;14;8;0;22
056046;VILLA SAN GIOVANNI IN TUSCIA;VT;1202;8;5;0;13
092099;VILLA SAN PIETRO;CA;2165;7;10;0;17
005119;VILLA SAN SECONDO;AT;379;9;4;0;13
066105;VILLA SANT'ANGELO;AQ;485;10;3;0;13
095048;VILLA SANT'ANTONIO;OR;333;4;10;0;14
060089;VILLA SANTA LUCIA;FR;2529;12;1;0;13
066104;VILLA SANTA LUCIA DEGLI ABRUZZI;AQ;91;11;2;0;13
069102;VILLA SANTA MARIA;CH;1120;9;2;0;11
030133;VILLA SANTINA;UD;2170;13;4;0;17
060090;VILLA SANTO STEFANO;FR;1651;10;3;0;13
095073;VILLA VERDE;OR;288;9;5;0;14
021113;VILLABASSA;BZ;1581;14;5;0;19
082079;VILLABATE;PA;19731;14;8;0;22
017200;VILLACHIARA;BS;1360;11;2;0;13
006182;VILLADEATI;AL;481;6;7;0;13
029048;VILLADOSE;RO;4796;8;9;0;17
004244;VILLAFALLETTO;CN;2859;11;1;0;12
005117;VILLAFRANCA D'ASTI;AT;2930;7;7;0;14
023096;VILLAFRANCA DI VERONA;VR;33044;22;10;0;32
045016;VILLAFRANCA IN LUNIGIANA;MS;4611;12;5;0;17
028103;VILLAFRANCA PADOVANA;PD;10515;9;7;0;16
001300;VILLAFRANCA PIEMONTE;TO;4562;13;4;0;17
084043;VILLAFRANCA SICULA;AG;1345;9;6;0;15
083105;VILLAFRANCA TIRRENA;ME;8148;13;5;0;18
082080;VILLAFRATI;PA;3083;9;8;0;17
024117;VILLAGA;VI;1872;8;5;0;13
091101;VILLAGRANDE STRISAILI;NU;3011;12;5;0;17
066103;VILLALAGO;AQ;520;7;4;0;11
085022;VILLALBA;CL;1446;7;8;0;15
069100;VILLALFONSINA;CH;897;9;4;0;13
006183;VILLALVERNIA;AL;876;10;3;0;13
069101;VILLAMAGNA;CH;2172;11;2;0;13
064117;VILLAMAINA;AV;916;10;3;0;13
029049;VILLAMARZANA;RO;1148;9;4;0;13
006184;VILLAMIROGLIO;AL;299;11;2;0;13
021114;VILLANDRO;BZ;1892;16;4;0;20
096079;VILLANOVA BIELLESE;BI;182;11;1;0;12
001301;VILLANOVA CANAVESE;TO;1205;8;5;0;13
009068;VILLANOVA D'ALBENGA;SV;2764;9;4;0;13
018179;VILLANOVA D'ARDENGHI;PV;770;6;7;0;13
005118;VILLANOVA D'ASTI;AT;5497;11;6;0;17
064118;VILLANOVA DEL BATTISTA;AV;1478;10;3;0;13
029050;VILLANOVA DEL GHEBBO;RO;1983;6;7;0;13
098060;VILLANOVA DEL SILLARO;LO;1850;12;1;0;13
028104;VILLANOVA DI CAMPOSAMPIERO;PD;6111;8;9;0;17
029051;VILLANOVA MARCHESANA;RO;879;9;4;0;13
004245;VILLANOVA MONDOVI';CN;5819;10;7;0;17
006185;VILLANOVA MONFERRATO;AL;1748;7;6;0;13
090078;VILLANOVA MONTELEONE;SS;2124;10;7;0;17
004246;VILLANOVA SOLARO;CN;735;10;3;0;13
033046;VILLANOVA SULL'ARDA;PC;1684;8;5;0;13
095071;VILLANOVA TRUSCHEDU;OR;293;8;6;0;14
018180;VILLANTERIO;PV;3324;10;7;0;17
017201;VILLANUOVA SUL CLISI;BS;5834;10;7;0;17
078154;VILLAPIANA;CS;5439;10;7;0;17
001303;VILLAR DORA;TO;2795;7;6;0;13
001305;VILLAR FOCCHIARDO;TO;1955;10;2;0;12
001306;VILLAR PELLICE;TO;1047;11;2;0;13
001307;VILLAR PEROSA;TO;3898;10;7;0;17
004247;VILLAR SAN COSTANZO;CN;1541;8;5;0;13
001302;VILLARBASSE;TO;3500;8;9;0;17
002163;VILLARBOIT;VC;386;11;2;0;13
001304;VILLAREGGIA;TO;996;8;5;0;13
063087;VILLARICCA;NA;31284;0;0;3;3
006186;VILLAROMAGNANO;AL;653;9;4;0;13
086020;VILLAROSA;EN;4450;11;6;0;17
001308;VILLASTELLONE;TO;4472;11;5;0;16
002164;VILLATA;VC;1550;8;5;0;13
095072;VILLAURBANA;OR;1490;11;6;0;17
066106;VILLAVALLELONGA;AQ;836;7;6;0;13
024118;VILLAVERLA;VI;6047;10;7;0;17
022249;VILLE D'ANAUNIA;TN;4729;15;9;0;24
022254;VILLE DI FIEMME;TN;2637;16;3;0;19
007074;VILLENEUVE;AO;1278;13;5;0;18
031025;VILLESSE;GO;1640;11;6;0;17
066107;VILLETTA BARREA;AQ;589;7;6;0;13
020068;VILLIMPENTA;MN;2093;6;7;0;13
016242;VILLONGO;BG;8027;10;7;0;17
026091;VILLORBA;TV;17603;11;11;0;22
016243;VILMINORE DI SCALVE;BG;1441;9;4;0;13
015242;VIMODRONE;MI;16753;11;11;0;22
004248;VINADIO;CN;599;10;2;0;12
070084;VINCHIATURO;CB;3296;9;8;0;17
005120;VINCHIO;AT;548;9;4;0;13
048050;VINCI;FI;14574;10;12;0;22
001309;VINOVO;TO;15154;13;9;0;22
003164;VINZAGLIO;NO;523;11;2;0;13
004249;VIOLA;CN;359;8;5;0;13
017202;VIONE;BS;627;9;4;0;13
021115;VIPITENO;BZ;6968;15;9;0;24
001310;VIRLE PIEMONTE;TO;1153;5;6;0;11
017203;VISANO;BS;1992;10;3;0;13
001311;VISCHE;TO;1196;6;7;0;13
063088;VISCIANO;NA;4199;13;4;0;17
030135;VISCO;UD;816;7;6;0;13
006187;VISONE;AL;1138;7;6;0;13
043057;VISSO;MC;996;7;6;0;13
018181;VISTARINO;PV;1518;7;6;0;13
001312;VISTRORIO;TO;506;8;5;0;13
081023;VITA;TP;1822;8;7;0;15
056059;VITERBO;VT;65931;24;17;0;41
060091;VITICUSO;FR;304;10;3;0;13
093049;VITO D'ASIO;PN;720;10;4;0;14
056060;VITORCHIANO;VT;5249;14;3;0;17
088012;VITTORIA;RG;62533;19;13;0;32
026092;VITTORIO VENETO;TV;27310;17;5;0;22
066108;VITTORITO;AQ;822;10;3;0;13
015243;VITTUONE;MI;9274;9;8;0;17
062077;VITULANO;BN;2734;10;3;0;13
061100;VITULAZIO;CE;7560;9;8;0;17
001313;VIU';TO;1023;9;4;0;13
093050;VIVARO;PN;1292;9;7;0;16
058113;VIVARO ROMANO;RM;165;10;3;0;13
096080;VIVERONE;BI;1353;8;5;0;13
087054;VIZZINI;CT;5747;9;7;0;16
012140;VIZZOLA TICINO;VA;586;11;2;0;13
015244;VIZZOLO PREDABISSI;MI;3852;9;8;0;17
028105;VO';PD;3283;12;5;0;17
017204;VOBARNO;BS;8257;11;6;0;17
010066;VOBBIA;GE;365;8;5;0;13
002166;VOCCA;VC;157;8;5;0;13
025066;VODO CADORE;BL;822;11;2;0;13
018182;VOGHERA;PV;38316;20;11;0;31
038023;VOGHIERA;FE;3633;11;6;0;17
022224;VOLANO;TN;3063;14;8;0;22
063089;VOLLA;NA;25369;14;7;0;21
019114;VOLONGO;CR;463;8;4;0;12
026093;VOLPAGO DEL MONTELLO;TV;10062;12;10;0;22
018183;VOLPARA;PV;124;8;4;0;12
006188;VOLPEDO;AL;1157;8;3;0;11
006189;VOLPEGLINO;AL;134;8;5;0;13
001314;VOLPIANO;TO;15199;13;9;0;22
020070;VOLTA MANTOVANA;MN;7205;11;6;0;17
006190;VOLTAGGIO;AL;667;11;2;0;13
025067;VOLTAGO AGORDINO;BL;829;10;3;0;13
050039;VOLTERRA;PI;9696;14;8;0;22
019115;VOLTIDO;CR;328;9;4;0;13
071061;VOLTURARA APPULA;FG;391;11;2;0;13
064119;VOLTURARA IRPINA;AV;3021;11;6;0;17
071062;VOLTURINO;FG;1554;6;7;0;13
001315;VOLVERA;TO;8521;9;8;0;17
004250;VOTTIGNASCO;CN;497;9;4;0;13
087055;ZAFFERANA ETNEA;CT;9383;8;9;0;17
079157;ZAGARISE;CZ;1475;10;3;0;13
058114;ZAGAROLO;RM;18344;16;6;0;22
016244;ZANDOBBIO;BG;2666;8;5;0;13
024119;ZANE';VI;6587;9;8;0;17
016245;ZANICA;BG;8671;12;5;0;17
071064;ZAPPONETA;FG;3284;14;3;0;17
018184;ZAVATTARELLO;PV;925;11;2;0;13
018185;ZECCONE;PV;1696;10;3;0;13
095074;ZEDDIANI;OR;1131;10;7;0;17
013246;ZELBIO;CO;182;11;2;0;13
098061;ZELO BUON PERSICO;LO;7418;9;8;0;17
018186;ZEME;PV;996;9;4;0;13
018187;ZENEVREDO;PV;476;8;5;0;13
026094;ZENSON DI PIAVE;TV;1741;4;7;0;11
033047;ZERBA;PC;70;10;3;0;13
018188;ZERBO;PV;396;6;7;0;13
018189;ZERBOLO';PV;1645;6;7;0;13
095075;ZERFALIU;OR;1017;9;5;0;14
045017;ZERI;MS;970;9;4;0;13
024120;ZERMEGHEDO;VI;1347;10;3;0;13
026095;ZERO BRANCO;TV;11488;13;9;0;22
023097;ZEVIO;VR;15492;13;9;0;22
022226;ZIANO DI FIEMME;TN;1758;11;6;0;17
033048;ZIANO PIACENTINO;PC;2441;8;5;0;13
015247;ZIBIDO SAN GIACOMO;MI;6837;10;7;0;17
011032;ZIGNAGO;SP;475;7;6;0;13
023098;ZIMELLA;VR;4824;14;3;0;17
096081;ZIMONE;BI;392;7;6;0;13
018190;ZINASCO;PV;3075;7;10;0;17
010067;ZOAGLI;GE;2306;9;4;0;13
036047;ZOCCA;MO;4572;11;6;0;17
016246;ZOGNO;BG;8585;11;6;0;17
037060;ZOLA PREDOSA;BO;19117;10;12;0;22
075094;ZOLLINO;LE;1892;10;3;0;13
017205;ZONE;BS;1039;12;1;0;13
025069;ZOPPE' DI CADORE;BL;191;10;3;0;13
093051;ZOPPOLA;PN;8346;13;9;0;22
024121;ZOVENCEDO;VI;798;7;6;0;13
096082;ZUBIENA;BI;1117;10;3;0;13
009069;ZUCCARELLO;SV;286;11;2;0;13
024122;ZUGLIANO;VI;6783;9;8;0;17
030136;ZUGLIO;UD;552;6;8;0;14
096083;ZUMAGLIA;BI;983;7;6;0;13
078155;ZUMPANO;CS;2633;8;5;0;13
064120;ZUNGOLI;AV;976;11;2;0;13
